N,Z,A,EL,MASSEXCESS,dMASSEXCESS,BINDINGENERGY_A,dBINDINGENERGY_A,IsCalculated
1, 0, 1, n, 8071.31806, 0.0004, 40.0, 0, 0
0, 1, 1, H, 7288.97106, 40.0000, 130.0, 0, 0
1, 1, 2, H, 13135.72289, 50.0000, 151112.2, 8310, 0
2, 1, 3, H, 14949.81090, 0.0000, 82827.2, 6540, 0
1, 2, 3, He, 14931.21888, 0.0000, 62572.6, 80440, 0
0, 3, 3, Li, 28667, 2000, -2267, 667, 0
3, 1, 4, H, 24621.129, 100.000, 1720.4, 49125, 0
2, 2, 4, He, 2424.91587, 0.0001, 57073.9, 1560, 0
1, 3, 4, Li, 25323.190, 212.132, 1153.7, 60353, 0
4, 1, 5, H, 32892.447, 89.443, 1336.3, 59217, 0
3, 2, 5, He, 11231.234, 20.000, 5512.1, 3254, 0
2, 3, 5, Li, 11678.887, 50.000, 5266.1, 32510, 0
1, 4, 5, Be, 37139, 2003, 18, 401, 0
5, 1, 6, H, 41875.725, 254.127, 961.6, 39542, 0
4, 2, 6, He, 17592.095, 0.053, 4878.5, 1990, 0
3, 3, 6, Li, 14086.88044, 0.0014, 45332.3, 3120, 0
2, 4, 6, Be, 18375.034, 5.448, 4487.2, 4780, 0
1, 5, 6, B, 47320, 2003, -467, 334, 0
6, 1, 7, H, 49135, 1004, 940, 143, 0
5, 2, 7, He, 26073.128, 7.559, 4123.0, 5781, 0
4, 3, 7, Li, 14907.10463, 0.0041, 95606.4, 4010, 0
3, 4, 7, Be, 15768.998, 0.071, 5371.5, 4870, 0
2, 5, 7, B, 27676.553, 25.150, 3558.7, 0553, 0
6, 2, 8, He, 31609.683, 0.089, 3924.5, 2100, 0
5, 3, 8, Li, 20945.805, 0.047, 5159.7, 1240, 0
4, 4, 8, Be, 4941.672, 0.035, 7062.4, 3560, 0
3, 5, 8, B, 22921.569, 1.000, 4717.1, 5510, 0
2, 6, 8, C, 35064.269, 18.243, 3101.5, 2422, 0
7, 2, 9, He, 40935.826, 46.816, 3349.0, 3805, 0
6, 3, 9, Li, 24954.905, 0.186, 5037.7, 6850, 0
5, 4, 9, Be, 11348.451, 0.076, 6462.6, 6930, 0
4, 5, 9, B, 12416.486, 0.903, 6257.0, 7130, 0
3, 6, 9, C, 28910.971, 2.137, 4337.4, 2330, 0
8, 2, 10, He, 49197.147, 92.848, 2995.1, 3409, 0
7, 3, 10, Li, 33052.628, 12.721, 4531.3, 5121, 0
6, 4, 10, Be, 12607.487, 0.081, 6497.6, 3060, 0
5, 5, 10, B, 12050.611, 0.015, 6475.0, 8350, 0
4, 6, 10, C, 15698.673, 0.070, 6032.0, 4260, 0
3, 7, 10, N, 38800.027, 400.000, 3643.6, 72440, 0
8, 3, 11, Li, 40728.259, 0.615, 4155.3, 8170, 0
7, 4, 11, Be, 20177.169, 0.238, 5952.5, 4020, 0
6, 5, 11, B, 8667.708, 0.012, 6927.7, 3230, 0
5, 6, 11, C, 10649.397, 0.060, 6676.4, 5630, 0
4, 7, 11, N, 24365.644, 5.000, 5358.4, 0230, 0
3, 8, 11, O, 47738.913, 60.038, 3162.4, 3725, 0
9, 3, 12, Li, 49009.577, 30.006, 3791.5, 9992, 0
8, 4, 12, Be, 25077.761, 1.909, 5720.7, 2230, 0
7, 5, 12, B, 13369.398, 1.321, 6631.2, 2370, 0
6, 6, 12, C, 0.0, 0.0, 7680.1, 4460, 0
5, 7, 12, N, 17338.068, 1.000, 6170.1, 1000, 0
4, 8, 12, O, 32013.335, 12.000, 4881.9, 7551, 0
10, 3, 13, Li, 56980.895, 70.003, 3507.6, 3075, 0
9, 4, 13, Be, 33659.080, 10.180, 5241.4, 3590, 0
8, 5, 13, B, 16561.948, 1.000, 6496.4, 1940, 0
7, 6, 13, C, 3125.00933, 0.0002, 37469.8, 4950, 0
6, 7, 13, N, 5345.481, 0.270, 7238.8, 6340, 0
5, 8, 13, O, 23115.432, 9.526, 5811.7, 6360, 0
4, 9, 13, F, 42030, 500, 4297, 38, 0
10, 4, 14, Be, 39954.502, 132.245, 4993.8, 9739, 0
9, 5, 14, B, 23663.686, 21.213, 6101.6, 4511, 0
8, 6, 14, C, 3019.89328, 0.0037, 57520.3, 1980, 0
7, 7, 14, N, 2863.41683, 0.0002, 27475.6, 1480, 0
6, 8, 14, O, 8007.781, 0.025, 7052.2, 7830, 0
5, 9, 14, F, 31964.403, 41.119, 5285.2, 0912, 0
11, 4, 15, Be, 49825.821, 165.797, 4540.9, 70811, 0
10, 5, 15, B, 28957.379, 21.029, 5880.0, 4381, 0
9, 6, 15, C, 9873.145, 0.800, 7100.1, 6960, 0
8, 7, 15, N, 101.43809, 0.0005, 87699.4, 6030, 0
7, 8, 15, O, 2855.622, 0.490, 7463.6, 9150, 0
6, 9, 15, F, 16566.752, 14.000, 6497.4, 5970, 0
5, 10, 15, Ne, 40215.374, 66.684, 4868.7, 2854, 0
12, 4, 16, Be, 57447.139, 165.797, 4285.2, 85110, 0
11, 5, 16, B, 37111.699, 24.566, 5507.3, 5351, 0
10, 6, 16, C, 13694.133, 3.578, 6922.0, 5460, 0
9, 7, 16, N, 5683.907, 2.301, 7373.7, 9710, 0
8, 8, 16, O, -4737.00217, 0.0003, 07976.2, 0720, 0
7, 9, 16, F, 10675.182, 5.364, 6964.0, 4900, 0
6, 10, 16, Ne, 23986.775, 20.480, 6083.1, 7771, 0
12, 5, 17, B, 43716.322, 204.104, 5269.6, 67712, 0
11, 6, 17, C, 21031.880, 17.365, 6558.0, 2621, 0
10, 7, 17, N, 7870.079, 15.000, 7286.2, 2940, 0
9, 8, 17, O, -808.76421, 0.0006, 47750.7, 2910, 0
8, 9, 17, F, 1951.701, 0.248, 7542.3, 2840, 0
7, 10, 17, Ne, 16500.452, 0.354, 6640.4, 9910, 0
6, 11, 17, Na, 34719.580, 59.616, 5522.7, 6533, 0
13, 5, 18, B, 51792.640, 204.165, 4976.6, 30611, 0
12, 6, 18, C, 24919.266, 30.000, 6426.1, 3211, 0
11, 7, 18, N, 13113.167, 18.570, 7038.5, 6271, 0
10, 8, 18, O, -782.81634, 0.0006, 47767.0, 9810, 0
9, 9, 18, F, 873.112, 0.463, 7631.6, 3830, 0
8, 10, 18, Ne, 5317.617, 0.363, 7341.2, 5770, 0
7, 11, 18, Na, 25037.992, 93.881, 6202.2, 1765, 0
14, 5, 19, B, 59770.251, 525.363, 4719.6, 34627, 0
13, 6, 19, C, 32413.754, 98.389, 6118.2, 7405, 0
12, 7, 19, N, 15856.255, 16.404, 6948.5, 4520, 0
11, 8, 19, O, 3332.858, 2.637, 7566.4, 9520, 0
10, 9, 19, F, -1487.44512, 0.0008, 27779.0, 1920, 0
9, 10, 19, Ne, 1752.054, 0.160, 7567.3, 4310, 0
8, 11, 19, Na, 12929.384, 10.535, 6937.8, 8640, 0
7, 12, 19, Mg, 31838.394, 60.001, 5901.4, 9923, 0
15, 5, 20, B, 69401.569, 546.357, 4405.6, 52927, 0
14, 6, 20, C, 37503.567, 230.625, 5961.4, 35611, 0
13, 7, 20, N, 21766.498, 78.894, 6709.1, 7173, 0
12, 8, 20, O, 3796.172, 0.885, 7568.5, 7070, 0
11, 9, 20, F, -17.463, 0.030, 7720.1, 3510, 0
10, 10, 20, Ne, -7041.93217, 0.0015, 48032.2, 4120, 0
9, 11, 20, Na, 6850.489, 1.109, 7298.5, 0280, 0
8, 12, 20, Mg, 17477.694, 1.863, 6728.0, 2520, 0
16, 5, 21, B, 78382.887, 558.664, 4152.5, 26526, 0
15, 6, 21, C, 45643, 596, 5674, 28, 0
14, 7, 21, N, 25231.915, 134.048, 6609.0, 1596, 0
13, 8, 21, O, 8062.034, 12.000, 7389.3, 7470, 0
12, 9, 21, F, -47.605, 1.800, 7738.2, 9340, 0
11, 10, 21, Ne, -5731.776, 0.038, 7971.7, 1360, 0
10, 11, 21, Na, -2184.857, 0.042, 7765.5, 5810, 0
9, 12, 21, Mg, 10903.851, 0.755, 7105.0, 3170, 0
8, 13, 21, Al, 27090, 600, 6297, 29, 0
16, 6, 22, C, 53611.203, 231.490, 5421.0, 77810, 0
15, 7, 22, N, 31764.805, 207.779, 6378.5, 3479, 0
14, 8, 22, O, 9283.032, 56.921, 7364.8, 7222, 0
13, 9, 22, F, 2793.376, 12.399, 7624.2, 9540, 0
12, 10, 22, Ne, -8024.716, 0.018, 8080.4, 6560, 0
11, 11, 22, Na, -5181.391, 0.132, 7915.6, 6240, 0
10, 12, 22, Mg, -399.986, 0.159, 7662.7, 6450, 0
9, 13, 22, Al, 18201, 401, 6782, 18, 0
8, 14, 22, Si, 33640, 500, 6044, 23, 0
17, 6, 23, C, 64171, 997, 5077, 43, 0
16, 7, 23, N, 36720.429, 420.570, 6236.6, 72118, 0
15, 8, 23, O, 14621.371, 121.712, 7163.4, 8565, 0
14, 9, 23, F, 3285.263, 33.320, 7622.3, 4471, 0
13, 10, 23, Ne, -5154.045, 0.104, 7955.2, 5610, 0
12, 11, 23, Na, -9529.85352, 0.0018, 18111.4, 9360, 0
11, 12, 23, Mg, -5473.675, 0.032, 7901.1, 2290, 0
10, 13, 23, Al, 6748.071, 0.345, 7335.7, 2750, 0
9, 14, 23, Si, 23950, 500, 6554, 22, 0
17, 7, 24, N, 46938, 401, 5887, 17, 0
16, 8, 24, O, 18500.404, 164.874, 7039.6, 8556, 0
15, 9, 24, F, 7544.516, 97.670, 7463.5, 8314, 0
14, 10, 24, Ne, -5951.642, 0.513, 7993.3, 2520, 0
13, 11, 24, Na, -8417.901, 0.017, 8063.4, 8820, 0
12, 12, 24, Mg, -13933.578, 0.013, 8260.7, 1030, 0
11, 13, 24, Al, -48.812, 0.228, 7649.5, 8060, 0
10, 14, 24, Si, 10745.186, 19.472, 7167.2, 3290, 0
9, 15, 24, P, 34020, 500, 6165, 21, 0
18, 7, 25, N, 55983, 503, 5613, 20, 0
17, 8, 25, O, 27329.030, 165.084, 6727.8, 0586, 0
16, 9, 25, F, 11334.167, 96.442, 7336.3, 0653, 0
15, 10, 25, Ne, -2035.503, 29.045, 7839.7, 9941, 0
14, 11, 25, Na, -9357.814, 1.200, 8101.3, 9790, 0
13, 12, 25, Mg, -13192.782, 0.047, 8223.5, 0280, 0
12, 13, 25, Al, -8915.974, 0.065, 8021.1, 3660, 0
11, 14, 25, Si, 3827.322, 10.000, 7480.1, 1090, 0
10, 15, 25, P, 20190, 400, 6794, 16, 0
18, 8, 26, O, 34661.041, 164.950, 6497.4, 7906, 0
17, 9, 26, F, 18674.655, 107.027, 7082.2, 4974, 0
16, 10, 26, Ne, 481.114, 18.429, 7751.9, 1100, 0
15, 11, 26, Na, -6860.780, 3.502, 8004.2, 0130, 0
14, 12, 26, Mg, -16214.544, 0.029, 8333.8, 7110, 0
13, 13, 26, Al, -12210.139, 0.066, 8149.7, 6530, 0
12, 14, 26, Si, -7141.003, 0.108, 7924.7, 0830, 0
11, 15, 26, P, 10973, 196, 7198, 8, 0
10, 16, 26, S, 27680, 600, 6525, 23, 0
19, 8, 27, O, 44670, 500, 6185, 19, 0
18, 9, 27, F, 25133.478, 120.198, 6879.6, 6624, 0
17, 10, 27, Ne, 7050.910, 90.770, 7520.4, 1513, 0
16, 11, 27, Na, -5517.791, 3.726, 7956.9, 4670, 0
15, 12, 27, Mg, -14586.594, 0.047, 8263.8, 5250, 0
14, 13, 27, Al, -17196.864, 0.047, 8331.5, 5330, 0
13, 14, 27, Si, -12384.505, 0.107, 8124.3, 4200, 0
12, 15, 27, P, -659.032, 9.001, 7661.0, 8940, 0
11, 16, 27, S, 17491, 400, 6960, 15, 0
20, 8, 28, O, 52080, 699, 5988, 25, 0
19, 9, 28, F, 33403.796, 120.347, 6626.8, 5674, 0
18, 10, 28, Ne, 11299.738, 126.068, 7388.3, 4634, 0
17, 11, 28, Na, -988.315, 10.246, 7799.2, 6440, 0
16, 12, 28, Mg, -15019.946, 0.261, 8272.4, 5310, 0
15, 13, 28, Al, -16850.719, 0.049, 8309.8, 9690, 0
14, 14, 28, Si, -21492.79711, 0.0005, 18447.7, 4450, 0
13, 15, 28, P, -7147.856, 1.147, 7907.4, 8420, 0
12, 16, 28, S, 4073.203, 160.000, 7478.7, 9115, 0
11, 17, 28, Cl, 28270, 500, 6587, 18, 0
20, 9, 29, F, 40150.190, 525.363, 6444.0, 31418, 0
19, 10, 29, Ne, 18399.803, 149.505, 7167.0, 6735, 0
18, 11, 29, Na, 2679.994, 7.337, 7682.1, 5220, 0
17, 12, 29, Mg, -10612.360, 0.345, 8113.5, 3170, 0
16, 13, 29, Al, -18207.762, 0.345, 8348.4, 6470, 0
15, 14, 29, Si, -21895.08154, 0.0005, 68448.6, 3610, 0
14, 15, 29, P, -16952.849, 0.359, 8251.2, 3680, 0
13, 16, 29, S, -3094.423, 13.041, 7746.3, 8260, 0
12, 17, 29, Cl, 14022, 189, 7129, 7, 0
11, 18, 29, Ar, 37969, 439, 6276, 15, 0
21, 9, 30, F, 48960, 500, 6205, 17, 0
20, 10, 30, Ne, 23280.120, 253.250, 7034.5, 3178, 0
19, 11, 30, Na, 8474.670, 4.727, 7501.9, 6850, 0
18, 12, 30, Mg, -8881.373, 1.295, 8054.4, 2500, 0
17, 13, 30, Al, -15864.116, 1.936, 8261.1, 0490, 0
16, 14, 30, Si, -24432.962, 0.022, 8520.6, 5490, 0
15, 15, 30, P, -20200.856, 0.065, 8353.5, 0640, 0
14, 16, 30, S, -14059.254, 0.206, 8122.7, 0810, 0
13, 17, 30, Cl, 4674.548, 23.876, 7472.1, 6980, 0
12, 18, 30, Ar, 22071, 179, 6866, 6, 0
22, 9, 31, F, 56843, 535, 6011, 17, 0
21, 10, 31, Ne, 31181.594, 266.195, 6813.0, 9028, 0
20, 11, 31, Na, 12246.031, 13.972, 7398.6, 7780, 0
19, 12, 31, Mg, -3122.152, 3.074, 7869.1, 8860, 0
18, 13, 31, Al, -14950.709, 2.236, 8225.5, 1800, 0
17, 14, 31, Si, -22949.037, 0.043, 8458.2, 9160, 0
16, 15, 31, P, -24440.54442, 0.0007, 58481.1, 6770, 0
15, 16, 31, S, -19042.531, 0.229, 8281.8, 0130, 0
14, 17, 31, Cl, -7034.552, 3.447, 7869.2, 1010, 0
13, 18, 31, Ar, 11325, 200, 7252, 6, 0
12, 19, 31, K, 34260, 300, 6487, 10, 0
22, 10, 32, Ne, 36999, 503, 6671, 16, 0
21, 11, 32, Na, 18640.152, 37.260, 7219.8, 8151, 0
20, 12, 32, Mg, -828.901, 3.260, 7803.8, 4110, 0
19, 13, 32, Al, -11099.368, 7.173, 8100.3, 4490, 0
18, 14, 32, Si, -24077.689, 0.298, 8481.4, 6900, 0
17, 15, 32, P, -24304.876, 0.040, 8464.1, 2030, 0
16, 16, 32, S, -26015.53714, 0.0013, 18493.1, 3010, 0
15, 17, 32, Cl, -13334.706, 0.562, 8072.4, 0580, 0
14, 18, 32, Ar, -2200.352, 1.770, 7700.0, 0890, 0
13, 19, 32, K, 21990, 400, 6920, 12, 0
23, 10, 33, Ne, 46130, 600, 6436, 18, 0
22, 11, 33, Na, 23780.113, 449.912, 7089.9, 26213, 0
21, 12, 33, Mg, 4962.873, 2.663, 7636.4, 3820, 0
20, 13, 33, Al, -8497.382, 6.986, 8020.6, 1720, 0
19, 14, 33, Si, -20514.328, 0.699, 8361.0, 5960, 0
18, 15, 33, P, -26337.350, 1.090, 8513.8, 0730, 0
17, 16, 33, S, -26585.85830, 0.0013, 48497.6, 3040, 0
16, 17, 33, Cl, -21003.340, 0.391, 8304.7, 5570, 0
15, 18, 33, Ar, -9384.295, 0.401, 7928.9, 5590, 0
14, 19, 33, K, 7540, 200, 7392, 6, 0
13, 20, 33, Ca, 31030, 400, 6657, 12, 0
24, 10, 34, Ne, 52842, 513, 6287, 15, 0
23, 11, 34, Na, 31680.114, 599.416, 6886.4, 37717, 0
22, 12, 34, Mg, 8323.324, 6.893, 7550.3, 9190, 0
21, 13, 34, Al, -2997.619, 2.105, 7860.3, 5060, 0
20, 14, 34, Si, -19991.684, 0.801, 8337.1, 6590, 0
19, 15, 34, P, -24548.702, 0.810, 8448.1, 8560, 0
18, 16, 34, S, -29931.689, 0.045, 8583.4, 9860, 0
17, 17, 34, Cl, -24440.086, 0.049, 8398.9, 7060, 0
16, 18, 34, Ar, -18378.293, 0.078, 8197.6, 7240, 0
15, 19, 34, K, -1220, 196, 7670, 6, 0
14, 20, 34, Ca, 14890, 300, 7173, 9, 0
24, 11, 35, Na, 37831, 670, 6745, 19, 0
23, 12, 35, Mg, 15639.786, 269.668, 7356.2, 3387, 0
22, 13, 35, Al, -223.730, 7.359, 7787.1, 2430, 0
21, 14, 35, Si, -14391.480, 35.857, 8169.5, 6441, 0
20, 15, 35, P, -24857.809, 1.866, 8446.2, 4960, 0
19, 16, 35, S, -28846.210, 0.040, 8537.8, 5110, 0
18, 17, 35, Cl, -29013.532, 0.035, 8520.2, 7900, 0
17, 18, 35, Ar, -23047.289, 0.680, 8327.4, 6210, 0
16, 19, 35, K, -11172.893, 0.512, 7965.8, 4090, 0
15, 20, 35, Ca, 5190, 200, 7476, 6, 0
14, 21, 35, Sc, 27100, 400, 6828, 11, 0
25, 11, 36, Na, 45903, 687, 6557, 19, 0
24, 12, 36, Mg, 20380.159, 690.237, 7244.4, 20219, 0
23, 13, 36, Al, 5950.384, 149.505, 7623.5, 1544, 0
22, 14, 36, Si, -12436.125, 71.797, 8112.5, 1991, 0
21, 15, 36, P, -20251.045, 13.114, 8307.8, 6920, 0
20, 16, 36, S, -30664.141, 0.188, 8575.3, 9000, 0
19, 17, 36, Cl, -29522.008, 0.036, 8521.9, 3220, 0
18, 18, 36, Ar, -30231.542, 0.027, 8519.9, 0960, 0
17, 19, 36, K, -17417.182, 0.325, 8142.2, 2330, 0
16, 20, 36, Ca, -6451.166, 40.000, 7815.8, 7991, 0
15, 21, 36, Sc, 16150, 300, 7166, 8, 0
26, 11, 37, Na, 53134, 687, 6403, 19, 0
25, 12, 37, Mg, 28211.478, 698.947, 7055.1, 11518, 0
24, 13, 37, Al, 9809.564, 180.244, 7531.3, 1604, 0
23, 14, 37, Si, -6571.512, 113.809, 7952.9, 0333, 0
22, 15, 37, P, -18996.012, 37.948, 8267.5, 5611, 0
21, 16, 37, S, -26896.426, 0.198, 8459.9, 3630, 0
20, 17, 37, Cl, -31761.552, 0.052, 8570.2, 8160, 0
19, 18, 37, Ar, -30947.679, 0.207, 8527.1, 4060, 0
18, 19, 37, K, -24800.201, 0.094, 8339.8, 4800, 0
17, 20, 37, Ca, -13136.070, 0.634, 8003.4, 5670, 0
16, 21, 37, Sc, 3780, 300, 7525, 8, 0
15, 22, 37, Ti, 25170, 400, 6926, 11, 0
27, 11, 38, Na, 61905, 715, 6216, 19, 0
26, 12, 38, Mg, 34074, 503, 6928, 13, 0
25, 13, 38, Al, 16470, 150, 7370, 4, 0
24, 14, 38, Si, -4170.299, 104.793, 7892.8, 2972, 0
23, 15, 38, P, -14621.565, 72.581, 8147.2, 7491, 0
22, 16, 38, S, -26861.216, 7.172, 8448.7, 8290, 0
21, 17, 38, Cl, -29798.116, 0.098, 8505.4, 8170, 0
20, 18, 38, Ar, -34714.827, 0.195, 8614.2, 8070, 0
19, 19, 38, K, -28800.760, 0.195, 8438.0, 5930, 0
18, 20, 38, Ca, -22058.503, 0.194, 8240.0, 4340, 0
17, 21, 38, Sc, -4249, 200, 7751, 5, 0
16, 22, 38, Ti, 11370, 300, 7319, 8, 0
28, 11, 39, Na, 69977, 743, 6056, 19, 0
27, 12, 39, Mg, 42775, 513, 6734, 13, 0
26, 13, 39, Al, 21490, 300, 7260, 8, 0
25, 14, 39, Si, 2320.352, 135.532, 7730.9, 7933, 0
24, 15, 39, P, -12774.636, 112.645, 8097.9, 7012, 0
23, 16, 39, S, -23162.672, 50.000, 8344.2, 6981, 0
22, 17, 39, Cl, -29800.218, 1.732, 8494.4, 0320, 0
21, 18, 39, Ar, -33242.195, 5.000, 8562.5, 9880, 0
20, 19, 39, K, -33807.19535, 0.0045, 68557.0, 2580, 0
19, 20, 39, Ca, -27282.707, 0.596, 8369.6, 7110, 0
18, 21, 39, Sc, -14172.726, 24.000, 8013.4, 5750, 0
17, 22, 39, Ti, 2500, 200, 7566, 5, 0
16, 23, 39, V, 22570, 400, 7031, 10, 0
28, 12, 40, Mg, 49550, 500, 6598, 13, 0
27, 13, 40, Al, 28820, 300, 7097, 7, 0
26, 14, 40, Si, 5666.876, 121.991, 7655.8, 2473, 0
25, 15, 40, P, -8139.189, 83.607, 7981.4, 1772, 0
24, 16, 40, S, -22837.850, 3.982, 8329.3, 2550, 0
23, 17, 40, Cl, -27557.818, 32.066, 8427.7, 6600, 0
22, 18, 40, Ar, -35039.89997, 0.0021, 88595.2, 5940, 0
21, 19, 40, K, -33535.497, 0.056, 8538.0, 9070, 0
20, 20, 40, Ca, -34846.402, 0.020, 8551.3, 0460, 0
19, 21, 40, Sc, -20523.353, 2.828, 8173.6, 6970, 0
18, 22, 40, Ti, -8993.439, 68.244, 7865.8, 6321, 0
17, 23, 40, V, 12470, 300, 7310, 7, 0
29, 12, 41, Mg, 58100, 500, 6425, 12, 0
28, 13, 41, Al, 34590, 400, 6980, 10, 0
27, 14, 41, Si, 13200, 300, 7482, 7, 0
26, 15, 41, P, -4979.767, 120.163, 7906.5, 5132, 0
25, 16, 41, S, -19008.580, 4.099, 8229.6, 3580, 0
24, 17, 41, Cl, -27307.192, 68.723, 8412.9, 5931, 0
23, 18, 41, Ar, -33067.510, 0.347, 8534.3, 7330, 0
22, 19, 41, K, -35559.54880, 0.0037, 68576.0, 7310, 0
21, 20, 41, Ca, -35137.908, 0.138, 8546.7, 0750, 0
20, 21, 41, Sc, -28642.360, 0.077, 8369.1, 9790, 0
19, 22, 41, Ti, -15697.539, 27.945, 8034.3, 8890, 0
18, 23, 41, V, 310, 200, 7625, 5, 0
17, 24, 41, Cr, 20410, 400, 7116, 10, 0
29, 13, 42, Al, 41990, 500, 6829, 12, 0
28, 14, 42, Si, 16840, 300, 7410, 7, 0
27, 15, 42, P, 1091.842, 95.009, 7765.9, 1222, 0
26, 16, 42, S, -17637.748, 2.794, 8193.2, 2750, 0
25, 17, 42, Cl, -24831.770, 59.616, 8345.8, 8641, 0
24, 18, 42, Ar, -34422.678, 5.775, 8555.6, 1410, 0
23, 19, 42, K, -35022.031, 0.106, 8551.2, 5710, 0
22, 20, 42, Ca, -38547.293, 0.148, 8616.5, 6460, 0
21, 21, 42, Sc, -32121.003, 0.154, 8444.9, 3030, 0
20, 22, 42, Ti, -25104.353, 0.269, 8259.2, 4000, 0
19, 23, 42, V, -7620, 196, 7824, 5, 0
18, 24, 42, Cr, 7060, 300, 7456, 7, 0
30, 13, 43, Al, 48270, 600, 6712, 14, 0
29, 14, 43, Si, 24330, 400, 7251, 9, 0
28, 15, 43, P, 5040, 300, 7681, 7, 0
27, 16, 43, S, -12195.461, 4.970, 8063.8, 2760, 0
26, 17, 43, Cl, -24159.510, 61.859, 8323.8, 6721, 0
25, 18, 43, Ar, -32009.811, 5.310, 8488.2, 3820, 0
24, 19, 43, K, -36575.394, 0.410, 8576.2, 2040, 0
23, 20, 43, Ca, -38408.873, 0.227, 8600.6, 6530, 0
22, 21, 43, Sc, -36188.150, 1.863, 8530.8, 2650, 0
21, 22, 43, Ti, -29315.591, 5.719, 8352.8, 0540, 0
20, 23, 43, V, -17916.358, 42.849, 8069.5, 1290, 0
19, 24, 43, Cr, -1970, 200, 7680, 5, 0
18, 25, 43, Mn, 17370, 400, 7213, 9, 0
30, 14, 44, Si, 29310, 500, 7156, 11, 0
29, 15, 44, P, 11110, 400, 7552, 9, 0
28, 16, 44, S, -9204.236, 5.216, 7996.0, 1540, 0
27, 17, 44, Cl, -20478.973, 85.566, 8234.4, 7881, 0
26, 18, 44, Ar, -32673.260, 1.584, 8493.8, 4110, 0
25, 19, 44, K, -35781.498, 0.419, 8546.7, 0230, 0
24, 20, 44, Ca, -41468.730, 0.325, 8658.1, 7690, 0
23, 21, 44, Sc, -37816.035, 1.756, 8557.3, 8050, 0
22, 22, 44, Ti, -37548.586, 0.700, 8533.5, 2150, 0
21, 23, 44, V, -23808.079, 7.265, 8203.4, 5670, 0
20, 24, 44, Cr, -13421.899, 51.232, 7949.6, 2651, 0
19, 25, 44, Mn, 7460, 300, 7457, 7, 0
31, 14, 45, Si, 37090, 600, 7004, 13, 0
30, 15, 45, P, 15960, 500, 7456, 11, 0
29, 16, 45, S, -3340, 300, 7867, 7, 0
28, 17, 45, Cl, -18262.544, 136.163, 8181.5, 9913, 0
27, 18, 45, Ar, -29770.801, 0.512, 8419.9, 5260, 0
26, 19, 45, K, -36615.643, 0.522, 8554.6, 7470, 0
25, 20, 45, Ca, -40812.230, 0.365, 8630.5, 4670, 0
24, 21, 45, Sc, -41072.321, 0.663, 8618.9, 4100, 0
23, 22, 45, Ti, -39010.266, 0.836, 8555.7, 3210, 0
22, 23, 45, V, -31886.441, 0.863, 8380.0, 3940, 0
21, 24, 45, Cr, -19514.801, 35.397, 8087.7, 2860, 0
20, 25, 45, Mn, -4980, 300, 7747, 7, 0
19, 26, 45, Fe, 14408, 283, 7299, 6, 0
31, 15, 46, P, 22840, 500, 7320, 11, 0
30, 16, 46, S, 640, 400, 7785, 9, 0
29, 17, 46, Cl, -13734.949, 97.249, 8080.7, 7572, 0
28, 18, 46, Ar, -29771.255, 2.329, 8412.3, 8350, 0
27, 19, 46, K, -35413.929, 0.727, 8518.0, 4280, 0
26, 20, 46, Ca, -43139.610, 2.234, 8668.9, 8480, 0
25, 21, 46, Sc, -41761.643, 0.671, 8622.0, 2150, 0
24, 22, 46, Ti, -44128.269, 0.090, 8656.4, 6230, 0
23, 23, 46, V, -37075.897, 0.134, 8486.1, 4230, 0
22, 24, 46, Cr, -29471.570, 11.453, 8303.8, 2330, 0
21, 25, 46, Mn, -12417.748, 86.629, 7916.0, 8051, 0
20, 26, 46, Fe, 1210, 300, 7603, 7, 0
32, 15, 47, P, 28810, 600, 7209, 13, 0
31, 16, 47, S, 7200, 400, 7652, 9, 0
30, 17, 47, Cl, -9580, 200, 7992, 4, 0
29, 18, 47, Ar, -25367.274, 1.211, 8311.4, 2500, 0
28, 19, 47, K, -35711.982, 1.397, 8514.8, 7950, 0
27, 20, 47, Ca, -42344.665, 2.221, 8639.3, 5480, 0
26, 21, 47, Sc, -44336.842, 1.931, 8665.0, 9580, 0
25, 22, 47, Ti, -44937.612, 0.080, 8661.2, 3250, 0
24, 23, 47, V, -42007.070, 0.110, 8582.2, 3480, 0
23, 24, 47, Cr, -34563.093, 5.197, 8407.2, 0670, 0
22, 25, 47, Mn, -22566.376, 31.671, 8135.3, 1170, 0
21, 26, 47, Fe, -7130, 500, 7790, 11, 0
20, 27, 47, Co, 10620, 600, 7396, 13, 0
32, 16, 48, S, 12390, 500, 7552, 10, 0
31, 17, 48, Cl, -4280, 500, 7883, 10, 0
30, 18, 48, Ar, -22354.927, 16.767, 8243.6, 6560, 0
29, 19, 48, K, -32284.482, 0.773, 8434.2, 3240, 0
28, 20, 48, Ca, -44224.868, 0.018, 8666.6, 9160, 0
27, 21, 48, Sc, -44504.083, 4.950, 8656.2, 0970, 0
26, 22, 48, Ti, -48492.952, 0.074, 8723.0, 1220, 0
25, 23, 48, V, -44478.005, 0.972, 8623.0, 6860, 0
24, 24, 48, Cr, -42821.313, 7.311, 8572.2, 5530, 0
23, 25, 48, Mn, -29296.644, 6.699, 8274.1, 9240, 0
22, 26, 48, Fe, -18008.575, 92.218, 8022.7, 2541, 0
21, 27, 48, Co, 1730, 500, 7595, 10, 0
20, 28, 48, Ni, 18178, 424, 7236, 9, 0
33, 16, 49, S, 20391, 583, 7400, 12, 0
32, 17, 49, Cl, 740, 400, 7785, 8, 0
31, 18, 49, Ar, -17060, 400, 8132, 8, 0
30, 19, 49, K, -29611.496, 0.801, 8372.2, 7530, 0
29, 20, 49, Ca, -41300.003, 0.178, 8594.8, 5000, 0
28, 21, 49, Sc, -46562.447, 2.268, 8686.2, 8050, 0
27, 22, 49, Ti, -48564.012, 0.078, 8711.1, 6250, 0
26, 23, 49, V, -47962.157, 0.824, 8682.9, 1350, 0
25, 24, 49, Cr, -45332.352, 2.202, 8613.2, 7770, 0
24, 25, 49, Mn, -37619.925, 2.214, 8439.9, 1500, 0
23, 26, 49, Fe, -24750.730, 24.219, 8161.3, 1210, 0
22, 27, 49, Co, -9780, 500, 7840, 10, 0
21, 28, 49, Ni, 8530, 600, 7450, 12, 0
33, 17, 50, Cl, 7700, 400, 7651, 8, 0
32, 18, 50, Ar, -13230, 500, 8054, 10, 0
31, 19, 50, K, -25727.853, 7.731, 8288.5, 8330, 0
30, 20, 50, Ca, -39589.230, 1.584, 8550.1, 6390, 0
29, 21, 50, Sc, -44537.120, 2.515, 8633.4, 7470, 0
28, 22, 50, Ti, -51431.867, 0.082, 8755.7, 2270, 0
27, 23, 50, V, -49223.240, 0.093, 8695.9, 0320, 0
26, 24, 50, Cr, -50261.364, 0.094, 8701.0, 1880, 0
25, 25, 50, Mn, -42626.886, 0.115, 8532.6, 8230, 0
24, 26, 50, Fe, -34476.460, 8.383, 8354.0, 2680, 0
23, 27, 50, Co, -17589.403, 125.752, 8000.6, 3872, 0
22, 28, 50, Ni, -3460, 500, 7702, 10, 0
34, 17, 51, Cl, 14290, 700, 7530, 14, 0
33, 18, 51, Ar, -6490, 400, 7922, 8, 0
32, 19, 51, K, -22515.457, 13.041, 8221.3, 3500, 0
31, 20, 51, Ca, -36332.310, 0.522, 8476.9, 1350, 0
30, 21, 51, Sc, -43250.353, 2.515, 8597.2, 2130, 0
29, 22, 51, Ti, -49732.965, 0.484, 8708.9, 9120, 0
28, 23, 51, V, -52203.105, 0.097, 8742.0, 8520, 0
27, 24, 51, Cr, -51450.715, 0.167, 8711.9, 9230, 0
26, 25, 51, Mn, -48243.225, 0.304, 8633.7, 6020, 0
25, 26, 51, Fe, -40189.185, 1.398, 8460.4, 9770, 0
24, 27, 51, Co, -27342.146, 48.438, 8193.2, 5490, 0
23, 28, 51, Ni, -11650, 500, 7870, 10, 0
35, 17, 52, Cl, 22360, 700, 7386, 13, 0
34, 18, 52, Ar, -1380, 600, 7827, 12, 0
33, 19, 52, K, -17137.628, 33.534, 8115.0, 3030, 0
32, 20, 52, Ca, -34266.272, 0.671, 8429.3, 8210, 0
31, 21, 52, Sc, -40523.560, 3.074, 8534.6, 6950, 0
30, 22, 52, Ti, -49477.698, 2.747, 8691.8, 1930, 0
29, 23, 52, V, -51443.032, 0.159, 8714.5, 6900, 0
28, 24, 52, Cr, -55419.508, 0.112, 8775.9, 9460, 0
27, 25, 52, Mn, -50711.387, 0.129, 8670.4, 0870, 0
26, 26, 52, Fe, -48332.095, 0.179, 8609.6, 0790, 0
25, 27, 52, Co, -34343.979, 5.282, 8325.5, 6060, 0
24, 28, 52, Ni, -22559.856, 82.903, 8083.8, 9771, 0
23, 29, 52, Cu, -1880, 600, 7671, 12, 0
35, 18, 53, Ar, 6791, 699, 7677, 13, 0
34, 19, 53, K, -12295.722, 111.779, 8022.8, 4882, 0
33, 20, 53, Ca, -29387.707, 43.780, 8330.5, 7780, 0
32, 21, 53, Sc, -38769.555, 17.698, 8492.8, 3250, 0
31, 22, 53, Ti, -46881.433, 2.888, 8631.1, 2560, 0
30, 23, 53, V, -51851.675, 3.103, 8710.1, 4250, 0
29, 24, 53, Cr, -55287.618, 0.116, 8760.2, 1030, 0
28, 25, 53, Mn, -54690.350, 0.346, 8734.1, 7980, 0
27, 26, 53, Fe, -50947.483, 1.669, 8648.7, 9850, 0
26, 27, 53, Co, -42659.376, 1.727, 8477.6, 5780, 0
25, 28, 53, Ni, -29630.827, 25.150, 8217.0, 7490, 0
24, 29, 53, Cu, -13140, 500, 7891, 9, 0
36, 18, 54, Ar, 12560, 800, 7578, 15, 0
35, 19, 54, K, -5150, 400, 7891, 7, 0
34, 20, 54, Ca, -25160.587, 48.438, 8247.4, 9670, 0
33, 21, 54, Sc, -34437.934, 13.973, 8404.8, 1150, 0
32, 22, 54, Ti, -45743.812, 15.835, 8599.6, 9170, 0
31, 23, 54, V, -49898.267, 11.180, 8662.1, 3820, 0
30, 24, 54, Cr, -56935.379, 0.132, 8777.9, 6720, 0
29, 25, 54, Mn, -55558.247, 1.007, 8737.9, 7680, 0
28, 26, 54, Fe, -56254.615, 0.343, 8736.3, 8460, 0
27, 27, 54, Co, -48010.068, 0.355, 8569.2, 1990, 0
26, 28, 54, Ni, -39278.312, 4.657, 8393.0, 3280, 0
25, 29, 54, Cu, -21240, 400, 8045, 7, 0
24, 30, 54, Zn, -5702, 217, 7742, 4, 0
36, 19, 55, K, 470, 500, 7792, 9, 0
35, 20, 55, Ca, -18650.375, 160.217, 8125.9, 2602, 0
34, 21, 55, Sc, -30842.108, 62.411, 8333.3, 6941, 0
33, 22, 55, Ti, -41832.469, 28.876, 8518.9, 6960, 0
32, 23, 55, V, -49125.136, 27.013, 8637.3, 3910, 0
31, 24, 55, Cr, -55110.324, 0.228, 8731.9, 3620, 0
30, 25, 55, Mn, -57712.542, 0.260, 8765.0, 2470, 0
29, 26, 55, Fe, -57481.422, 0.308, 8746.5, 9810, 0
28, 27, 55, Co, -54029.996, 0.405, 8669.6, 2040, 0
27, 28, 55, Ni, -45335.961, 0.705, 8497.3, 2250, 0
26, 29, 55, Cu, -31635.403, 155.560, 8233.9, 9702, 0
25, 30, 55, Zn, -14270, 400, 7904, 7, 0
37, 19, 56, K, 7980, 600, 7663, 11, 0
36, 20, 56, Ca, -13510.390, 249.640, 8033.1, 6544, 0
35, 21, 56, Sc, -25515.848, 259.665, 8233.5, 7814, 0
34, 22, 56, Ti, -39422.995, 100.201, 8467.9, 4951, 0
33, 23, 56, V, -46183.401, 175.884, 8574.7, 0063, 0
32, 24, 56, Cr, -55285.128, 0.578, 8723.2, 6090, 0
31, 25, 56, Mn, -56911.666, 0.293, 8738.3, 3580, 0
30, 26, 56, Fe, -60607.163, 0.268, 8790.3, 5630, 0
29, 27, 56, Co, -56040.518, 0.475, 8694.8, 3860, 0
28, 28, 56, Ni, -53907.649, 0.399, 8642.7, 8110, 0
27, 29, 56, Cu, -38629.733, 6.395, 8355.9, 9070, 0
26, 30, 56, Zn, -25390, 400, 8106, 7, 0
25, 31, 56, Ga, -3840, 500, 7707, 9, 0
38, 19, 57, K, 14130, 600, 7563, 11, 0
37, 20, 57, Ca, -6560, 400, 7912, 7, 0
36, 21, 57, Sc, -21379.653, 179.778, 8158.1, 6663, 0
35, 22, 57, Ti, -34401.848, 205.879, 8372.9, 0083, 0
34, 23, 57, V, -44435.063, 84.766, 8535.1, 9671, 0
33, 24, 57, Cr, -52524.985, 1.863, 8663.3, 9980, 0
32, 25, 57, Mn, -57486.279, 1.505, 8736.7, 1460, 0
31, 26, 57, Fe, -60182.017, 0.268, 8770.2, 8290, 0
30, 27, 57, Co, -59345.658, 0.516, 8741.8, 8450, 0
29, 28, 57, Ni, -56083.961, 0.566, 8670.9, 3640, 0
28, 29, 57, Cu, -47309.014, 0.501, 8503.2, 6460, 0
27, 30, 57, Zn, -32550, 200, 8231, 4, 0
26, 31, 57, Ga, -15410, 400, 7916, 7, 0
39, 19, 58, K, 21930, 700, 7437, 12, 0
38, 20, 58, Ca, -1530, 500, 7828, 9, 0
37, 21, 58, Sc, -15479.569, 190.025, 8054.9, 4363, 0
36, 22, 58, Ti, -30917.668, 183.340, 8307.6, 2903, 0
35, 23, 58, V, -40430.584, 95.816, 8458.1, 5601, 0
34, 24, 58, Cr, -51991.808, 2.981, 8643.9, 9870, 0
33, 25, 58, Mn, -55827.568, 2.701, 8696.6, 4380, 0
32, 26, 58, Fe, -62155.271, 0.316, 8792.2, 5340, 0
31, 27, 58, Co, -59847.292, 1.153, 8738.9, 7190, 0
30, 28, 58, Ni, -60228.871, 0.349, 8732.0, 6210, 0
29, 29, 58, Cu, -51667.851, 0.564, 8570.9, 6960, 0
28, 30, 58, Zn, -42298.871, 50.001, 8395.9, 4670, 0
27, 31, 58, Ga, -23540, 300, 8059, 5, 0
26, 32, 58, Ge, -7580, 500, 7770, 9, 0
40, 19, 59, K, 28750, 800, 7332, 14, 0
39, 20, 59, Ca, 5810, 600, 7708, 10, 0
38, 21, 59, Sc, -10829.550, 249.640, 7976.4, 0734, 0
37, 22, 59, Ti, -25880, 300, 8218, 5, 0
36, 23, 59, V, -37610.617, 137.400, 8403.8, 0342, 0
35, 24, 59, Cr, -48115.931, 0.671, 8568.5, 9950, 0
34, 25, 59, Mn, -55525.328, 2.329, 8680.9, 2240, 0
33, 26, 59, Fe, -60664.957, 0.330, 8754.7, 7460, 0
32, 27, 59, Co, -62229.838, 0.397, 8768.0, 3790, 0
31, 28, 59, Ni, -61156.833, 0.351, 8736.5, 9120, 0
30, 29, 59, Cu, -56358.454, 0.528, 8642.0, 0270, 0
29, 30, 59, Zn, -47215.678, 0.759, 8473.7, 8020, 0
28, 31, 59, Ga, -33760, 170, 8232, 3, 0
27, 32, 59, Ge, -16370, 400, 7924, 7, 0
40, 20, 60, Ca, 11000, 700, 7627, 12, 0
39, 21, 60, Sc, -4550, 500, 7873, 8, 0
38, 22, 60, Ti, -22099.698, 240.325, 8152.7, 8584, 0
37, 23, 60, V, -33087.402, 181.946, 8322.8, 7513, 0
36, 24, 60, Cr, -46908.500, 1.118, 8540.1, 8760, 0
35, 25, 60, Mn, -52967.946, 2.329, 8628.1, 3920, 0
34, 26, 60, Fe, -61413.174, 3.406, 8755.8, 5390, 0
33, 27, 60, Co, -61650.437, 0.403, 8746.7, 6920, 0
32, 28, 60, Ni, -64473.243, 0.353, 8780.7, 7690, 0
31, 29, 60, Cu, -58345.262, 1.613, 8665.6, 0470, 0
30, 30, 60, Zn, -54174.470, 0.548, 8583.0, 5240, 0
29, 31, 60, Ga, -39590, 200, 8327, 3, 0
28, 32, 60, Ge, -27530, 300, 8113, 5, 0
27, 33, 60, As, -5640, 400, 7735, 7, 0
41, 20, 61, Ca, 19010, 800, 7503, 13, 0
40, 21, 61, Sc, 500, 600, 7794, 10, 0
39, 22, 61, Ti, -16370, 300, 8058, 5, 0
38, 23, 61, V, -30177.121, 234.920, 8271.0, 4173, 0
37, 24, 61, Cr, -42496.502, 1.863, 8460.1, 7340, 0
36, 25, 61, Mn, -51742.130, 2.329, 8598.9, 1570, 0
35, 26, 61, Fe, -58920.503, 2.608, 8703.7, 6860, 0
34, 27, 61, Co, -62898.179, 0.839, 8756.1, 5100, 0
33, 28, 61, Ni, -64222.029, 0.355, 8765.0, 2810, 0
32, 29, 61, Cu, -61984.063, 0.951, 8715.5, 1480, 0
31, 30, 61, Zn, -56348.906, 15.899, 8610.3, 0980, 0
30, 31, 61, Ga, -47134.662, 37.994, 8446.4, 3130, 0
29, 32, 61, Ge, -33790, 300, 8215, 5, 0
28, 33, 61, As, -17200, 300, 7930, 5, 0
41, 21, 62, Sc, 7310, 600, 7688, 10, 0
40, 22, 62, Ti, -12200, 400, 7990, 6, 0
39, 23, 62, V, -25213.164, 264.287, 8187.7, 5654, 0
38, 24, 62, Cr, -40852.611, 3.447, 8427.3, 8710, 0
37, 25, 62, Mn, -48523.965, 6.542, 8538.5, 0020, 0
36, 26, 62, Fe, -58878.057, 2.794, 8692.8, 8310, 0
35, 27, 62, Co, -61424.399, 18.574, 8721.3, 3470, 0
34, 28, 62, Ni, -66746.440, 0.425, 8794.5, 5550, 0
33, 29, 62, Cu, -62787.543, 0.637, 8718.0, 8390, 0
32, 30, 62, Zn, -61168.088, 0.615, 8679.3, 4510, 0
31, 31, 62, Ga, -51987.022, 0.637, 8518.6, 4490, 0
30, 32, 62, Ge, -42140, 140, 8347, 2, 0
29, 33, 62, As, -24420, 300, 8049, 5, 0
42, 21, 63, Sc, 13070, 700, 7603, 11, 0
41, 22, 63, Ti, -5860, 500, 7891, 8, 0
40, 23, 63, V, -21740.141, 339.995, 8130.7, 8095, 0
39, 24, 63, Cr, -36178.299, 72.657, 8347.5, 3981, 0
38, 25, 63, Mn, -46887.061, 3.726, 8505.1, 0200, 0
37, 26, 63, Fe, -55635.629, 4.302, 8631.5, 4990, 0
36, 27, 63, Co, -61851.553, 18.575, 8717.7, 9720, 0
35, 28, 63, Ni, -65512.891, 0.426, 8763.4, 9550, 0
34, 29, 63, Cu, -65579.868, 0.426, 8752.1, 4040, 0
33, 30, 63, Zn, -62213.429, 1.560, 8686.2, 8660, 0
32, 31, 63, Ga, -56547.100, 1.304, 8583.9, 2670, 0
31, 32, 63, Ge, -46921.221, 37.260, 8418.7, 1670, 0
30, 33, 63, As, -33500, 200, 8193, 3, 0
29, 34, 63, Se, -16850, 500, 7917, 8, 0
42, 22, 64, Ti, -1480, 600, 7826, 9, 0
41, 23, 64, V, -16320, 400, 8045, 6, 0
40, 24, 64, Cr, -33639.978, 299.941, 8303.5, 6264, 0
39, 25, 64, Mn, -42989.040, 3.540, 8437.4, 1750, 0
38, 26, 64, Fe, -54969.552, 5.017, 8612.3, 8880, 0
37, 27, 64, Co, -59792.442, 20.005, 8675.5, 2230, 0
36, 28, 64, Ni, -67099.034, 0.463, 8777.4, 6370, 0
35, 29, 64, Cu, -65424.418, 0.427, 8739.0, 7360, 0
34, 30, 64, Zn, -66004.018, 0.644, 8735.9, 0570, 0
33, 31, 64, Ga, -58832.827, 1.429, 8611.6, 3170, 0
32, 32, 64, Ge, -54315.503, 3.726, 8528.8, 2430, 0
31, 33, 64, As, -39532, 203, 8286, 3, 0
30, 34, 64, Se, -26860, 500, 8075, 8, 0
43, 22, 65, Ti, 5210, 700, 7726, 11, 0
42, 23, 65, V, -12110, 500, 7981, 8, 0
41, 24, 65, Cr, -28310, 200, 8218, 3, 0
40, 25, 65, Mn, -40967.344, 3.726, 8400.6, 8220, 0
39, 26, 65, Fe, -51217.902, 5.112, 8546.3, 4700, 0
38, 27, 65, Co, -59185.205, 2.083, 8656.8, 8480, 0
37, 28, 65, Ni, -65125.796, 0.483, 8736.2, 4240, 0
36, 29, 65, Cu, -67263.677, 0.643, 8757.0, 9670, 0
35, 30, 65, Zn, -65912.024, 0.646, 8724.2, 6600, 0
34, 31, 65, Ga, -62657.486, 0.791, 8662.1, 6010, 0
33, 32, 65, Ge, -56478.223, 2.165, 8555.0, 5840, 0
32, 33, 65, As, -46937.056, 84.766, 8396.2, 3511, 0
31, 34, 65, Se, -33020, 300, 8170, 5, 0
30, 35, 65, Br, -16490, 500, 7904, 8, 0
43, 23, 66, V, -6300, 500, 7894, 8, 0
42, 24, 66, Cr, -25140, 300, 8168, 5, 0
41, 25, 66, Mn, -36750.392, 11.178, 8331.7, 9860, 0
40, 26, 66, Fe, -50067.847, 4.099, 8521.7, 2450, 0
39, 27, 66, Co, -56408.541, 13.972, 8605.9, 4190, 0
38, 28, 66, Ni, -66006.293, 1.397, 8739.5, 0860, 0
37, 29, 66, Cu, -66258.289, 0.649, 8731.4, 7300, 0
36, 30, 66, Zn, -68899.229, 0.744, 8759.6, 3350, 0
35, 31, 66, Ga, -63723.729, 1.092, 8669.3, 6310, 0
34, 32, 66, Ge, -61607.041, 2.401, 8625.4, 3830, 0
33, 33, 66, As, -52025.084, 5.682, 8468.4, 0340, 0
32, 34, 66, Se, -41660, 200, 8300, 3, 0
31, 35, 66, Br, -23570, 400, 8014, 6, 0
44, 23, 67, V, -1744, 600, 7829, 9, 0
43, 24, 67, Cr, -19270, 400, 8079, 6, 0
42, 25, 67, Mn, -33580, 200, 8281, 3, 0
41, 26, 67, Fe, -45708.416, 3.819, 8449.9, 3590, 0
40, 27, 67, Co, -55321.783, 6.443, 8581.7, 4220, 0
39, 28, 67, Ni, -63742.688, 2.888, 8695.7, 5050, 0
38, 29, 67, Cu, -67319.553, 0.892, 8737.4, 5970, 0
37, 30, 67, Zn, -67880.376, 0.755, 8734.1, 5340, 0
36, 31, 67, Ga, -66879.156, 1.176, 8707.5, 3300, 0
35, 32, 67, Ge, -62673.718, 4.319, 8633.0, 8840, 0
34, 33, 67, As, -56587.232, 0.443, 8530.5, 6850, 0
33, 34, 67, Se, -46580.294, 67.068, 8369.5, 3441, 0
32, 35, 67, Br, -32530, 300, 8148, 4, 0
31, 36, 67, Kr, -15552, 424, 7883, 6, 0
44, 24, 68, Cr, -15690, 500, 8026, 7, 0
43, 25, 68, Mn, -28920, 300, 8209, 4, 0
42, 26, 68, Fe, -43897, 193, 8418, 3, 0
41, 27, 68, Co, -51642.591, 3.859, 8520.1, 3010, 0
40, 28, 68, Ni, -63463.822, 2.981, 8682.4, 6670, 0
39, 29, 68, Cu, -65567.043, 1.584, 8701.8, 9130, 0
38, 30, 68, Zn, -70007.154, 0.778, 8755.6, 8200, 0
37, 31, 68, Ga, -67086.054, 1.430, 8701.2, 1950, 0
36, 32, 68, Ge, -66978.799, 1.876, 8688.1, 3710, 0
35, 33, 68, As, -58894.527, 1.846, 8557.7, 4570, 0
34, 34, 68, Se, -54189.449, 0.496, 8477.0, 4820, 0
33, 35, 68, Br, -38791, 259, 8239, 4, 0
32, 36, 68, Kr, -25626, 500, 8034, 7, 0
45, 24, 69, Cr, -9630, 500, 7939, 7, 0
44, 25, 69, Mn, -25360, 400, 8155, 6, 0
43, 26, 69, Fe, -39199, 200, 8345, 3, 0
42, 27, 69, Co, -50385.447, 85.697, 8495.4, 0621, 0
41, 28, 69, Ni, -59978.656, 3.726, 8623.0, 9980, 0
40, 29, 69, Cu, -65736.221, 1.397, 8695.2, 0440, 0
39, 30, 69, Zn, -68417.906, 0.795, 8722.7, 3110, 0
38, 31, 69, Ga, -69327.820, 1.197, 8724.5, 7980, 0
37, 32, 69, Ge, -67100.674, 1.318, 8680.9, 6400, 0
36, 33, 69, As, -63112.181, 31.999, 8611.8, 2140, 0
35, 34, 69, Se, -56434.714, 1.490, 8503.7, 0820, 0
34, 35, 69, Br, -46259.478, 42.003, 8344.9, 0260, 0
33, 36, 69, Kr, -32140, 300, 8129, 4, 0
46, 24, 70, Cr, -5640, 600, 7884, 9, 0
45, 25, 70, Mn, -20450, 500, 8084, 7, 0
44, 26, 70, Fe, -36890, 300, 8308, 4, 0
43, 27, 70, Co, -46524.963, 10.992, 8434.1, 9800, 0
42, 28, 70, Ni, -59213.868, 2.144, 8604.2, 9170, 0
41, 29, 70, Cu, -62976.381, 1.082, 8646.8, 6550, 0
40, 30, 70, Zn, -69564.748, 1.918, 8729.8, 0860, 0
39, 31, 70, Ga, -68910.150, 1.201, 8709.2, 8080, 0
38, 32, 70, Ge, -70562.036, 0.820, 8721.7, 0280, 0
37, 33, 70, As, -64333.973, 1.397, 8621.5, 5410, 0
36, 34, 70, Se, -61929.900, 1.584, 8576.0, 3380, 0
35, 35, 70, Br, -51425.627, 14.904, 8414.7, 9640, 0
34, 36, 70, Kr, -41100, 200, 8256, 3, 0
46, 25, 71, Mn, -16620, 500, 8030, 7, 0
45, 26, 71, Fe, -31930, 400, 8235, 6, 0
44, 27, 71, Co, -44369.930, 465.030, 8398.7, 3446, 0
43, 28, 71, Ni, -55406.236, 2.237, 8543.1, 5640, 0
42, 29, 71, Cu, -62711.134, 1.490, 8635.0, 2330, 0
41, 30, 71, Zn, -67328.786, 2.654, 8689.0, 4170, 0
40, 31, 71, Ga, -70139.127, 0.811, 8717.6, 0500, 0
39, 32, 71, Ge, -69906.657, 0.815, 8703.3, 1180, 0
38, 33, 71, As, -67893.257, 4.163, 8663.9, 3500, 0
37, 34, 71, Se, -63146.515, 2.794, 8586.0, 6060, 0
36, 35, 71, Br, -56502.426, 5.402, 8481.4, 6290, 0
35, 36, 71, Kr, -46327.211, 128.769, 8327.1, 3101, 0
34, 37, 71, Rb, -32290, 400, 8118, 6, 0
47, 25, 72, Mn, -11170, 600, 7955, 8, 0
46, 26, 72, Fe, -29250, 500, 8195, 7, 0
45, 27, 72, Co, -40300, 300, 8338, 4, 0
44, 28, 72, Ni, -54226.068, 2.237, 8520.2, 1180, 0
43, 29, 72, Cu, -59783.006, 1.397, 8586.5, 2560, 0
42, 30, 72, Zn, -68145.495, 2.142, 8691.8, 0530, 0
41, 31, 72, Ga, -68588.284, 0.818, 8687.0, 8930, 0
40, 32, 72, Ge, -72585.910, 0.076, 8731.7, 4590, 0
39, 33, 72, As, -68229.808, 4.083, 8660.3, 7860, 0
38, 34, 72, Se, -67868.189, 1.956, 8644.4, 9020, 0
37, 35, 72, Br, -59061.750, 1.025, 8511.3, 1260, 0
36, 36, 72, Kr, -53940.582, 8.011, 8429.3, 1930, 0
35, 37, 72, Rb, -38330, 500, 8202, 7, 0
48, 25, 73, Mn, -6700, 600, 7895, 8, 0
47, 26, 73, Fe, -23990, 500, 8121, 7, 0
46, 27, 73, Co, -37970, 300, 8302, 4, 0
45, 28, 73, Ni, -50108.159, 2.423, 8457.6, 5290, 0
44, 29, 73, Cu, -58987.445, 1.942, 8568.5, 6990, 0
43, 30, 73, Zn, -65593.411, 1.863, 8648.3, 4550, 0
42, 31, 73, Ga, -69699.343, 1.677, 8693.8, 7400, 0
41, 32, 73, Ge, -71297.532, 0.057, 8705.0, 5000, 0
40, 33, 73, As, -70952.757, 3.853, 8689.6, 0990, 0
39, 34, 73, Se, -68227.396, 7.424, 8641.5, 5910, 0
38, 35, 73, Br, -63645.787, 6.741, 8568.0, 8030, 0
37, 36, 73, Kr, -56551.758, 6.578, 8460.1, 8470, 0
36, 37, 73, Rb, -46011.611, 40.794, 8305.0, 8210, 0
35, 38, 73, Sr, -31950, 401, 8102, 5, 0
48, 26, 74, Fe, -20660, 500, 8076, 7, 0
47, 27, 74, Co, -33540, 400, 8239, 5, 0
46, 28, 74, Ni, -48700, 200, 8433, 3, 0
45, 29, 74, Cu, -56006.213, 6.148, 8521.5, 6330, 0
44, 30, 74, Zn, -65756.720, 2.515, 8642.7, 5470, 0
43, 31, 74, Ga, -68049.626, 2.994, 8663.1, 6760, 0
42, 32, 74, Ge, -73422.451, 0.013, 8725.2, 0110, 0
41, 33, 74, As, -70860.064, 1.693, 8680.0, 0200, 0
40, 34, 74, Se, -72213.210, 0.015, 8687.7, 1550, 0
39, 35, 74, Br, -65288.161, 5.835, 8583.5, 6150, 0
38, 36, 74, Kr, -62331.844, 2.013, 8533.0, 3900, 0
37, 37, 74, Rb, -51916.016, 3.027, 8381.7, 1230, 0
36, 38, 74, Sr, -40827, 100, 8221, 1, 0
49, 26, 75, Fe, -14700, 600, 7996, 8, 0
48, 27, 75, Co, -30560, 400, 8197, 5, 0
47, 28, 75, Ni, -44240, 200, 8369, 3, 0
46, 29, 75, Cu, -54470.219, 0.718, 8495.0, 8010, 0
45, 30, 75, Zn, -62558.916, 1.956, 8592.4, 9810, 0
44, 31, 75, Ga, -68460.639, 0.671, 8660.7, 5650, 0
43, 32, 75, Ge, -71856.973, 0.052, 8695.6, 0960, 0
42, 33, 75, As, -73034.203, 0.884, 8700.8, 7480, 0
41, 34, 75, Se, -72169.489, 0.073, 8678.9, 1390, 0
40, 35, 75, Br, -69107.020, 4.285, 8627.6, 4970, 0
39, 36, 75, Kr, -64323.632, 8.104, 8553.4, 3990, 0
38, 37, 75, Rb, -57218.702, 1.180, 8448.2, 7620, 0
37, 38, 75, Sr, -46618.702, 220.003, 8296.5, 1162, 0
36, 39, 75, Y, -31820, 300, 8089, 4, 0
50, 26, 76, Fe, -10590, 600, 7943, 8, 0
49, 27, 76, Co, -25660, 500, 8131, 7, 0
48, 28, 76, Ni, -42190, 300, 8338, 4, 0
47, 29, 76, Cu, -50981.627, 0.913, 8443.6, 0180, 0
46, 30, 76, Zn, -62303.024, 1.456, 8582.2, 7350, 0
45, 31, 76, Ga, -66296.648, 1.956, 8624.5, 2720, 0
44, 32, 76, Ge, -73212.898, 0.018, 8705.2, 3640, 0
43, 33, 76, As, -72291.384, 0.886, 8682.8, 1720, 0
42, 34, 76, Se, -75251.959, 0.016, 8711.4, 7810, 0
41, 35, 76, Br, -70289.078, 9.322, 8635.8, 8300, 0
40, 36, 76, Kr, -69013.706, 4.013, 8608.8, 0770, 0
39, 37, 76, Rb, -60479.089, 0.938, 8486.2, 1610, 0
38, 38, 76, Sr, -54247.645, 34.465, 8393.9, 2940, 0
37, 39, 76, Y, -38250, 300, 8173, 4, 0
50, 27, 77, Co, -21910, 600, 8082, 8, 0
49, 28, 77, Ni, -37350, 400, 8272, 5, 0
48, 29, 77, Cu, -48862.828, 1.211, 8411.2, 5010, 0
47, 30, 77, Zn, -58789.203, 1.973, 8530.0, 0370, 0
46, 31, 77, Ga, -65992.352, 2.422, 8613.3, 9070, 0
45, 32, 77, Ge, -71212.870, 0.053, 8671.0, 2930, 0
44, 33, 77, As, -73916.334, 1.692, 8695.9, 7890, 0
43, 34, 77, Se, -74599.497, 0.062, 8694.6, 9080, 0
42, 35, 77, Br, -73234.818, 2.811, 8666.8, 0730, 0
41, 36, 77, Kr, -70169.451, 1.956, 8616.8, 3700, 0
40, 37, 77, Rb, -64830.500, 1.304, 8537.3, 3960, 0
39, 38, 77, Sr, -57803.443, 7.918, 8435.9, 1880, 0
38, 39, 77, Y, -46439, 203, 8278, 3, 0
37, 40, 77, Zr, -31600, 400, 8075, 5, 0
51, 27, 78, Co, -15320, 700, 7997, 9, 0
50, 28, 78, Ni, -34880, 400, 8238, 5, 0
49, 29, 78, Cu, -44789.474, 13.332, 8354.6, 6950, 0
48, 30, 78, Zn, -57483.242, 1.944, 8507.3, 8000, 0
47, 31, 78, Ga, -63704.085, 1.051, 8577.1, 0430, 0
46, 32, 78, Ge, -71862.058, 3.536, 8671.6, 6360, 0
45, 33, 78, As, -72816.970, 9.779, 8673.8, 7600, 0
44, 34, 78, Se, -77025.952, 0.179, 8717.8, 0720, 0
43, 35, 78, Br, -73452.168, 3.580, 8661.9, 5940, 0
42, 36, 78, Kr, -74178.283, 0.307, 8661.2, 3850, 0
41, 37, 78, Rb, -66935.427, 3.237, 8558.3, 5120, 0
40, 38, 78, Sr, -63173.949, 7.452, 8500.0, 9710, 0
39, 39, 78, Y, -52173, 298, 8349, 4, 0
38, 40, 78, Zr, -40850, 400, 8194, 5, 0
51, 28, 79, Ni, -28160, 500, 8150, 6, 0
50, 29, 79, Cu, -42408.039, 104.979, 8320.9, 3801, 0
49, 30, 79, Zn, -53432.302, 2.225, 8450.5, 8250, 0
48, 31, 79, Ga, -62548.355, 1.208, 8556.0, 7250, 0
47, 32, 79, Ge, -69527.180, 37.161, 8634.5, 0890, 0
46, 33, 79, As, -73636.081, 5.325, 8676.6, 1720, 0
45, 34, 79, Se, -75917.466, 0.223, 8695.5, 9230, 0
44, 35, 79, Br, -76068.067, 1.001, 8687.5, 9560, 0
43, 36, 79, Kr, -74442.290, 3.480, 8657.1, 1300, 0
42, 37, 79, Rb, -70802.778, 1.943, 8601.1, 4010, 0
41, 38, 79, Sr, -65479.664, 7.421, 8523.8, 5580, 0
40, 39, 79, Y, -57802.935, 80.108, 8416.7, 7881, 0
39, 40, 79, Zr, -46770, 300, 8267, 4, 0
38, 41, 79, Nb, -31650, 500, 8066, 6, 0
52, 28, 80, Ni, -23240, 600, 8088, 7, 0
51, 29, 80, Cu, -36679, 300, 8246, 4, 0
50, 30, 80, Zn, -51648.619, 2.585, 8423.5, 4570, 0
49, 31, 80, Ga, -59223.675, 2.891, 8508.4, 5450, 0
48, 32, 80, Ge, -69535.314, 2.054, 8627.5, 7070, 0
47, 33, 80, As, -72214.601, 3.333, 8651.2, 8240, 0
46, 34, 80, Se, -77759.487, 0.947, 8710.8, 1420, 0
45, 35, 80, Br, -75889.025, 0.993, 8677.6, 5410, 0
44, 36, 80, Kr, -77893.455, 0.695, 8692.9, 3010, 0
43, 37, 80, Rb, -72175.476, 1.863, 8611.6, 7600, 0
42, 38, 80, Sr, -70311.467, 3.464, 8578.5, 9660, 0
41, 39, 80, Y, -61148.162, 6.242, 8454.2, 7590, 0
40, 40, 80, Zr, -54760, 300, 8365, 4, 0
39, 41, 80, Nb, -38420, 400, 8151, 5, 0
53, 28, 81, Ni, -16090, 700, 8000, 9, 0
52, 29, 81, Cu, -31910, 300, 8185, 4, 0
51, 30, 81, Zn, -46199.669, 5.030, 8351.9, 2620, 0
50, 31, 81, Ga, -57627.962, 3.264, 8483.3, 5760, 0
49, 32, 81, Ge, -66291.695, 2.055, 8580.6, 5870, 0
48, 33, 81, As, -72533.314, 2.644, 8648.0, 5710, 0
47, 34, 81, Se, -76389.019, 0.977, 8685.9, 9980, 0
46, 35, 81, Br, -77977.051, 0.978, 8695.9, 4650, 0
45, 36, 81, Kr, -77696.199, 1.074, 8682.8, 2060, 0
44, 37, 81, Rb, -75456.704, 4.904, 8645.5, 1390, 0
43, 38, 81, Sr, -71528.134, 3.128, 8587.3, 5450, 0
42, 39, 81, Y, -65712.919, 5.405, 8505.9, 0310, 0
41, 40, 81, Zr, -57524.418, 92.218, 8395.1, 5191, 0
40, 41, 81, Nb, -46360, 400, 8248, 5, 0
39, 42, 81, Mo, -31460, 500, 8054, 6, 0
54, 28, 82, Ni, -10720, 800, 7935, 10, 0
53, 29, 82, Cu, -25730, 400, 8108, 5, 0
52, 30, 82, Zn, -42313.960, 3.074, 8301.1, 1750, 0
51, 31, 82, Ga, -52930.725, 2.426, 8421.0, 4940, 0
50, 32, 82, Ge, -65415.075, 2.240, 8563.7, 5670, 0
49, 33, 82, As, -70105.427, 3.729, 8611.4, 1530, 0
48, 34, 82, Se, -77593.895, 0.466, 8693.1, 9730, 0
47, 35, 82, Br, -77498.677, 0.971, 8682.4, 9530, 0
46, 36, 82, Kr, -80591.79509, 0.0055, 18710.6, 7540, 0
45, 37, 82, Rb, -76187.813, 3.009, 8647.4, 2750, 0
44, 38, 82, Sr, -76010.062, 5.992, 8635.7, 1900, 0
43, 39, 82, Y, -68064.097, 5.499, 8529.2, 7620, 0
42, 40, 82, Zr, -63614.063, 1.584, 8465.4, 6660, 0
41, 41, 82, Nb, -51810, 300, 8312, 4, 0
40, 42, 82, Mo, -40370, 400, 8163, 5, 0
54, 29, 83, Cu, -20390, 500, 8044, 6, 0
53, 30, 83, Zn, -36290, 300, 8226, 4, 0
52, 31, 83, Ga, -49257.129, 2.612, 8372.5, 7560, 0
51, 32, 83, Ge, -60976.442, 2.427, 8504.3, 4620, 0
50, 33, 83, As, -69669.331, 2.799, 8599.6, 5400, 0
49, 34, 83, Se, -75340.543, 3.036, 8658.5, 5600, 0
48, 35, 83, Br, -79013.721, 3.795, 8693.3, 8520, 0
47, 36, 83, Kr, -79990.643, 0.009, 8695.7, 2950, 0
46, 37, 83, Rb, -79070.639, 2.329, 8675.2, 1930, 0
45, 38, 83, Sr, -76797.616, 6.834, 8638.4, 0760, 0
44, 39, 83, Y, -72205.672, 18.631, 8573.6, 5710, 0
43, 40, 83, Zr, -65911.659, 6.430, 8488.3, 9970, 0
42, 41, 83, Nb, -57612.910, 162.080, 8378.9, 8891, 0
41, 42, 83, Mo, -46340, 401, 8234, 5, 0
40, 43, 83, Tc, -31320, 500, 8043, 6, 0
55, 29, 84, Cu, -13720, 500, 7965, 6, 0
54, 30, 84, Zn, -31830, 400, 8171, 5, 0
53, 31, 84, Ga, -44094.136, 29.808, 8307.5, 2500, 0
52, 32, 84, Ge, -58148.435, 3.171, 8465.5, 2440, 0
51, 33, 84, As, -65853.568, 3.171, 8547.9, 3850, 0
50, 34, 84, Se, -75947.731, 1.961, 8658.7, 9350, 0
49, 35, 84, Br, -77783.094, 25.730, 8671.3, 2940, 0
48, 36, 84, Kr, -82439.34527, 0.0038, 28717.4, 4730, 0
47, 37, 84, Rb, -79758.975, 2.194, 8676.2, 2440, 0
46, 38, 84, Sr, -80649.580, 1.243, 8677.5, 1320, 0
45, 39, 84, Y, -73894.439, 4.299, 8587.7, 8120, 0
44, 40, 84, Zr, -71421.692, 5.499, 8549.0, 3010, 0
43, 41, 84, Nb, -61193.842, 0.401, 8417.9, 5630, 0
42, 42, 84, Mo, -54170, 298, 8325, 4, 0
41, 43, 84, Tc, -37700, 400, 8120, 5, 0
55, 30, 85, Zn, -25100, 500, 8090, 6, 0
54, 31, 85, Ga, -39744.059, 37.260, 8253.5, 6870, 0
53, 32, 85, Ge, -53123.427, 3.729, 8401.7, 6890, 0
52, 33, 85, As, -63189.152, 3.078, 8510.9, 8510, 0
51, 34, 85, Se, -72413.645, 2.613, 8610.3, 0450, 0
50, 35, 85, Br, -78575.478, 3.078, 8673.5, 9260, 0
49, 36, 85, Kr, -81480.341, 2.000, 8698.5, 6330, 0
48, 37, 85, Rb, -82167.34065, 0.0050, 08697.4, 4160, 0
47, 38, 85, Sr, -81103.290, 2.813, 8675.7, 1930, 0
46, 39, 85, Y, -77842.131, 18.965, 8628.1, 4860, 0
45, 40, 85, Zr, -73175.196, 6.430, 8564.0, 3940, 0
44, 41, 85, Nb, -66279.684, 4.099, 8473.7, 1170, 0
43, 42, 85, Mo, -57509.760, 15.835, 8361.3, 3200, 0
42, 43, 85, Tc, -45850, 400, 8215, 5, 0
41, 44, 85, Ru, -30630, 500, 8027, 6, 0
56, 30, 86, Zn, -20062, 500, 8032, 6, 0
55, 31, 86, Ga, -33760, 400, 8182, 5, 0
54, 32, 86, Ge, -49399.927, 437.802, 8354.6, 3005, 0
53, 33, 86, As, -58962.150, 3.450, 8456.7, 2150, 0
52, 34, 86, Se, -70503.175, 2.520, 8581.8, 2240, 0
51, 35, 86, Br, -75632.261, 3.078, 8632.3, 6590, 0
50, 36, 86, Kr, -83265.67593, 0.0037, 28712.0, 2950, 0
49, 37, 86, Rb, -82747.003, 0.200, 8696.9, 0140, 0
48, 38, 86, Sr, -84523.09977, 0.0052, 48708.4, 5660, 0
47, 39, 86, Y, -79283.100, 14.142, 8638.4, 2930, 0
46, 40, 86, Zr, -77969.023, 3.566, 8614.0, 5230, 0
45, 41, 86, Nb, -69134.061, 5.499, 8502.2, 2310, 0
44, 42, 86, Mo, -64110.927, 2.932, 8434.7, 1750, 0
43, 43, 86, Tc, -51570, 300, 8280, 3, 0
42, 44, 86, Ru, -39770, 400, 8133, 5, 0
56, 31, 87, Ga, -28870, 500, 8124, 6, 0
55, 32, 87, Ge, -43590, 300, 8285, 3, 0
54, 33, 87, As, -55617.914, 2.985, 8413.8, 5210, 0
53, 34, 87, Se, -66426.133, 2.241, 8529.0, 9200, 0
52, 35, 87, Br, -73891.685, 3.171, 8605.9, 1050, 0
51, 36, 87, Kr, -80709.531, 0.246, 8675.2, 8400, 0
50, 37, 87, Rb, -84597.802, 0.006, 8710.9, 8430, 0
49, 38, 87, Sr, -84880.07643, 0.0051, 38705.2, 3630, 0
48, 39, 87, Y, -83018.387, 1.128, 8674.8, 4510, 0
47, 40, 87, Zr, -79347.147, 4.146, 8623.6, 5450, 0
46, 41, 87, Nb, -73874.493, 6.802, 8551.7, 5790, 0
45, 42, 87, Mo, -66884.817, 2.857, 8462.4, 2430, 0
44, 43, 87, Tc, -57690.052, 4.192, 8347.7, 4490, 0
43, 44, 87, Ru, -45730, 400, 8201, 5, 0
57, 31, 88, Ga, -22390, 500, 8050, 6, 0
56, 32, 88, Ge, -39520, 400, 8236, 5, 0
55, 33, 88, As, -50450, 200, 8351, 2, 0
54, 34, 88, Se, -63884.203, 3.357, 8495.0, 0450, 0
53, 35, 88, Br, -70715.967, 3.171, 8563.7, 4790, 0
52, 36, 88, Kr, -79691.295, 2.608, 8656.8, 4990, 0
51, 37, 88, Rb, -82609.004, 0.159, 8681.1, 1540, 0
50, 38, 88, Sr, -87921.62876, 0.0056, 18732.5, 9580, 0
49, 39, 88, Y, -84299.029, 1.500, 8682.5, 3960, 0
48, 40, 88, Zr, -83628.874, 5.403, 8666.0, 3390, 0
47, 41, 88, Nb, -76171.555, 57.808, 8572.4, 0130, 0
46, 42, 88, Mo, -72686.553, 3.819, 8523.9, 0870, 0
45, 43, 88, Tc, -61670.301, 4.099, 8389.8, 3380, 0
44, 44, 88, Ru, -54340, 300, 8298, 3, 0
43, 45, 88, Rh, -36860, 400, 8090, 5, 0
57, 32, 89, Ge, -33040, 400, 8161, 4, 0
56, 33, 89, As, -46530, 300, 8304, 3, 0
55, 34, 89, Se, -58992.398, 3.729, 8435.2, 7990, 0
54, 35, 89, Br, -68274.271, 3.264, 8530.7, 8020, 0
53, 36, 89, Kr, -76535.795, 2.142, 8614.8, 1580, 0
52, 37, 89, Rb, -81712.399, 5.427, 8664.1, 8950, 0
51, 38, 89, Sr, -86209.026, 0.092, 8705.9, 2300, 0
50, 39, 89, Y, -87711.202, 0.339, 8714.0, 1100, 0
49, 40, 89, Zr, -84877.974, 2.780, 8673.3, 8650, 0
48, 41, 89, Nb, -80625.755, 23.630, 8616.8, 1840, 0
47, 42, 89, Mo, -75014.944, 3.912, 8544.9, 8510, 0
46, 43, 89, Tc, -67394.857, 3.819, 8450.5, 7580, 0
45, 44, 89, Ru, -58369.424, 24.219, 8340.3, 7600, 0
44, 45, 89, Rh, -45651, 361, 8189, 4, 0
58, 32, 90, Ge, -28470, 500, 8109, 6, 0
57, 33, 90, As, -40990, 400, 8240, 4, 0
56, 34, 90, Se, -55800.223, 329.749, 8395.7, 6723, 0
55, 35, 90, Br, -64000.306, 3.357, 8478.1, 8650, 0
54, 36, 90, Kr, -74959.259, 1.863, 8591.2, 5990, 0
53, 37, 90, Rb, -79365.573, 6.452, 8631.5, 2620, 0
52, 38, 90, Sr, -85950.945, 1.449, 8696.0, 0430, 0
51, 39, 90, Y, -86496.912, 0.354, 8693.3, 7780, 0
50, 40, 90, Zr, -88772.547, 0.118, 8709.9, 6990, 0
49, 41, 90, Nb, -82661.531, 3.317, 8633.3, 7700, 0
48, 42, 90, Mo, -80172.514, 3.463, 8597.0, 2850, 0
47, 43, 90, Tc, -70724.696, 1.025, 8483.3, 6000, 0
46, 44, 90, Ru, -64883.801, 3.730, 8409.7, 6840, 0
45, 45, 90, Rh, -51634, 200, 8254, 2, 0
44, 46, 90, Pd, -39710, 400, 8113, 4, 0
58, 33, 91, As, -36500, 400, 8189, 4, 0
57, 34, 91, Se, -50580.130, 433.145, 8334.8, 3824, 0
56, 35, 91, Br, -61107.301, 3.543, 8441.9, 2420, 0
55, 36, 91, Kr, -70973.974, 2.236, 8541.7, 5190, 0
54, 37, 91, Rb, -77745.049, 7.801, 8607.5, 6210, 0
53, 38, 91, Sr, -83651.950, 5.453, 8663.8, 7590, 0
52, 39, 91, Y, -86351.321, 1.843, 8684.9, 4210, 0
51, 40, 91, Zr, -87895.592, 0.095, 8693.3, 1490, 0
50, 41, 91, Nb, -86638.028, 2.926, 8670.8, 9830, 0
49, 42, 91, Mo, -82208.834, 6.238, 8613.6, 2860, 0
48, 43, 91, Tc, -75986.657, 2.363, 8536.6, 5580, 0
47, 44, 91, Ru, -68239.833, 2.221, 8442.9, 2870, 0
46, 45, 91, Rh, -58570, 298, 8328, 3, 0
45, 46, 91, Pd, -46170, 423, 8183, 5, 0
59, 33, 92, As, -30380, 500, 8121, 5, 0
58, 34, 92, Se, -46724, 400, 8290, 4, 0
57, 35, 92, Br, -56232.812, 6.709, 8384.9, 1230, 0
56, 36, 92, Kr, -68769.329, 2.701, 8512.6, 7500, 0
55, 37, 92, Rb, -74772.450, 6.123, 8569.4, 2250, 0
54, 38, 92, Sr, -82867.371, 3.423, 8648.9, 0700, 0
53, 39, 92, Y, -84816.494, 9.127, 8661.5, 8940, 0
52, 40, 92, Zr, -88459.024, 0.094, 8692.6, 7830, 0
51, 41, 92, Nb, -86453.290, 1.784, 8662.3, 7310, 0
50, 42, 92, Mo, -86808.587, 0.157, 8657.7, 3120, 0
49, 43, 92, Tc, -78925.703, 3.102, 8563.5, 4400, 0
48, 44, 92, Ru, -74301.211, 2.718, 8504.7, 7400, 0
47, 45, 92, Rh, -62999.095, 4.378, 8373.4, 2110, 0
46, 46, 92, Pd, -54779.095, 345.028, 8275.5, 6953, 0
45, 47, 92, Ag, -37530, 400, 8080, 4, 0
59, 34, 93, Se, -40860, 400, 8225, 4, 0
58, 35, 93, Br, -52890.235, 430.816, 8345.5, 9864, 0
57, 36, 93, Kr, -64136.002, 2.515, 8458.1, 0850, 0
56, 37, 93, Rb, -72619.900, 7.830, 8540.9, 2090, 0
55, 38, 93, Sr, -80085.844, 7.554, 8612.7, 8750, 0
54, 39, 93, Y, -84227.155, 10.488, 8648.9, 0540, 0
53, 40, 93, Zr, -87122.028, 0.456, 8671.6, 2070, 0
52, 41, 93, Nb, -87212.840, 1.490, 8664.1, 8490, 0
51, 42, 93, Mo, -86807.079, 0.181, 8651.4, 0950, 0
50, 43, 93, Tc, -83606.116, 1.012, 8608.5, 7820, 0
49, 44, 93, Ru, -77216.723, 2.065, 8531.4, 6270, 0
48, 45, 93, Rh, -69011.810, 2.629, 8434.8, 2550, 0
47, 46, 93, Pd, -58981.810, 370.009, 8318.5, 6373, 0
46, 47, 93, Ag, -46400, 401, 8175, 4, 0
60, 34, 94, Se, -36803, 500, 8180, 5, 0
59, 35, 94, Br, -47650, 200, 8287, 2, 0
58, 36, 94, Kr, -61347.780, 12.109, 8424.3, 3180, 0
57, 37, 94, Rb, -68562.791, 2.029, 8492.7, 6440, 0
56, 38, 94, Sr, -78845.721, 1.663, 8593.8, 3440, 0
55, 39, 94, Y, -82351.473, 6.380, 8622.8, 0680, 0
54, 40, 94, Zr, -87269.332, 0.164, 8666.8, 0160, 0
53, 41, 94, Nb, -86369.063, 1.491, 8648.9, 0140, 0
52, 42, 94, Mo, -88414.079, 0.141, 8662.3, 3410, 0
51, 43, 94, Tc, -84158.332, 4.071, 8608.7, 3730, 0
50, 44, 94, Ru, -82583.602, 3.143, 8583.6, 6200, 0
49, 45, 94, Rh, -72907.623, 3.379, 8472.4, 0330, 0
48, 46, 94, Pd, -66102.281, 4.287, 8391.6, 8320, 0
47, 47, 94, Ag, -52402, 400, 8238, 4, 0
46, 48, 94, Cd, -40440, 500, 8102, 5, 0
61, 34, 95, Se, -30460, 500, 8112, 5, 0
60, 35, 95, Br, -43850, 300, 8245, 3, 0
59, 36, 95, Kr, -56158.920, 18.630, 8365.9, 9630, 0
58, 37, 95, Rb, -65890.307, 20.245, 8460.1, 9670, 0
57, 38, 95, Sr, -75117.284, 5.810, 8549.0, 8750, 0
56, 39, 95, Y, -81207.937, 6.779, 8604.9, 6440, 0
55, 40, 95, Zr, -85659.940, 0.869, 8643.5, 9240, 0
54, 41, 95, Nb, -86786.272, 0.508, 8647.2, 1330, 0
53, 42, 95, Mo, -87711.872, 0.123, 8648.7, 2120, 0
52, 43, 95, Tc, -86021.355, 5.080, 8622.6, 9110, 0
51, 44, 95, Ru, -83457.759, 9.502, 8587.4, 7060, 0
50, 45, 95, Rh, -78340.616, 3.886, 8525.3, 7070, 0
49, 46, 95, Pd, -69965.913, 3.031, 8428.9, 8070, 0
48, 47, 95, Ag, -59906, 400, 8315, 4, 0
47, 48, 95, Cd, -47056, 566, 8171, 6, 0
61, 35, 96, Br, -38210, 300, 8184, 3, 0
60, 36, 96, Kr, -53081.682, 19.277, 8330.8, 7210, 0
59, 37, 96, Rb, -61354.351, 3.353, 8408.8, 9630, 0
58, 38, 96, Sr, -72918.248, 8.466, 8521.2, 0410, 0
57, 39, 96, Y, -78329.986, 6.075, 8569.4, 2690, 0
56, 40, 96, Zr, -85438.860, 0.114, 8635.3, 2830, 0
55, 41, 96, Nb, -85602.830, 0.147, 8628.8, 8680, 0
54, 42, 96, Mo, -88794.889, 0.120, 8653.9, 8800, 0
53, 43, 96, Tc, -85821.648, 5.146, 8614.8, 6730, 0
52, 44, 96, Ru, -86080.385, 0.170, 8609.4, 1300, 0
51, 45, 96, Rh, -79687.732, 10.001, 8534.6, 7350, 0
50, 46, 96, Pd, -76183.420, 4.194, 8490.0, 2070, 0
49, 47, 96, Ag, -64511.645, 90.084, 8360.2, 9030, 0
48, 48, 96, Cd, -55572, 410, 8259, 4, 0
47, 49, 96, In, -38090, 500, 8069, 5, 0
62, 35, 97, Br, -34000, 400, 8140, 4, 0
61, 36, 97, Kr, -47423.499, 130.409, 8269.8, 6451, 0
60, 37, 97, Rb, -58519.145, 1.912, 8376.1, 8720, 0
59, 38, 97, Sr, -68580.674, 3.385, 8471.8, 4890, 0
58, 39, 97, Y, -76115.455, 6.708, 8541.4, 6160, 0
57, 40, 97, Zr, -82936.693, 0.121, 8603.7, 1820, 0
56, 41, 97, Nb, -85602.797, 4.244, 8623.1, 3840, 0
55, 42, 97, Mo, -87544.700, 0.165, 8635.0, 9260, 0
54, 43, 97, Tc, -87224.436, 4.118, 8623.7, 2540, 0
53, 44, 97, Ru, -86120.564, 2.763, 8604.2, 7990, 0
52, 45, 97, Rh, -82597.564, 35.463, 8559.8, 9490, 0
51, 46, 97, Pd, -77805.852, 4.844, 8502.4, 3030, 0
50, 47, 97, Ag, -70904.027, 12.016, 8423.2, 1210, 0
49, 48, 97, Cd, -60734.027, 420.172, 8310.3, 0134, 0
48, 49, 97, In, -47390, 401, 8165, 4, 0
63, 35, 98, Br, -28050, 400, 8078, 4, 0
62, 36, 98, Kr, -44120, 300, 8234, 3, 0
61, 37, 98, Rb, -54369.152, 16.083, 8330.7, 2940, 0
60, 38, 98, Sr, -66422.389, 3.226, 8445.7, 3850, 0
59, 39, 98, Y, -72288.748, 7.919, 8497.6, 1620, 0
58, 40, 98, Zr, -81281.757, 8.445, 8581.3, 9840, 0
57, 41, 98, Nb, -83524.612, 5.001, 8596.3, 0160, 0
56, 42, 98, Mo, -88115.980, 0.174, 8635.1, 6910, 0
55, 43, 98, Tc, -86432.214, 3.380, 8610.0, 0470, 0
54, 44, 98, Ru, -88224.871, 6.463, 8620.3, 1400, 0
53, 45, 98, Rh, -83175.219, 11.906, 8560.8, 0380, 0
52, 46, 98, Pd, -81320.985, 4.742, 8533.8, 9990, 0
51, 47, 98, Ag, -73066.425, 32.907, 8441.6, 8660, 0
50, 48, 98, Cd, -67636.425, 51.797, 8378.2, 9530, 0
49, 49, 98, In, -53906, 304, 8230, 3, 0
63, 36, 99, Kr, -38400, 400, 8175, 4, 0
62, 37, 99, Rb, -51121.150, 4.031, 8295.3, 0100, 0
61, 38, 99, Sr, -62518.527, 4.737, 8402.5, 2350, 0
60, 39, 99, Y, -70643.730, 6.615, 8476.6, 9380, 0
59, 40, 99, Zr, -77616.670, 10.499, 8539.2, 2500, 0
58, 41, 99, Nb, -82335.344, 12.004, 8578.9, 8590, 0
57, 42, 99, Mo, -85970.106, 0.229, 8607.7, 9820, 0
56, 43, 99, Tc, -87327.869, 0.908, 8613.6, 1050, 0
55, 44, 99, Ru, -87625.385, 0.343, 8608.7, 1320, 0
54, 45, 99, Rh, -85584.522, 19.451, 8580.1, 9590, 0
53, 46, 99, Pd, -82182.861, 5.107, 8537.9, 3320, 0
52, 47, 99, Ag, -76712.483, 6.265, 8474.7, 7440, 0
51, 48, 99, Cd, -69931.132, 1.584, 8398.3, 7340, 0
50, 49, 99, In, -61376, 298, 8304, 3, 0
49, 50, 99, Sn, -47976, 582, 8161, 6, 0
64, 36, 100, Kr, -34470, 400, 8134, 4, 0
63, 37, 100, Rb, -46265.884, 13.124, 8244.5, 0850, 0
62, 38, 100, Sr, -59817.505, 6.918, 8372.2, 0120, 0
61, 39, 100, Y, -67321.241, 11.179, 8439.4, 1510, 0
60, 40, 100, Zr, -76372.736, 8.143, 8522.1, 0660, 0
59, 41, 100, Nb, -79791.246, 7.976, 8548.4, 6830, 0
58, 42, 100, Mo, -86193.029, 0.301, 8604.6, 6260, 0
57, 43, 100, Tc, -86020.951, 1.351, 8595.1, 1840, 0
56, 44, 100, Ru, -89227.391, 0.342, 8619.3, 5930, 0
55, 45, 100, Rh, -85591.130, 18.125, 8575.1, 7320, 0
54, 46, 100, Pd, -85212.672, 17.637, 8563.5, 6520, 0
53, 47, 100, Ag, -78137.969, 5.000, 8484.9, 9470, 0
52, 48, 100, Cd, -74194.595, 1.677, 8437.7, 3750, 0
51, 49, 100, In, -64178.146, 2.236, 8329.7, 4950, 0
50, 50, 100, Sn, -57148.146, 240.010, 8251.6, 2602, 0
65, 36, 101, Kr, -28580, 500, 8075, 5, 0
64, 37, 101, Rb, -42567.417, 20.493, 8206.1, 7530, 0
63, 38, 101, Sr, -55324.914, 8.480, 8324.7, 4110, 0
62, 39, 101, Y, -65054.787, 7.080, 8413.3, 3050, 0
61, 40, 101, Zr, -73160.987, 8.332, 8485.8, 4390, 0
60, 41, 101, Nb, -78891.488, 3.749, 8534.8, 3550, 0
59, 42, 101, Mo, -83519.952, 0.308, 8572.9, 1590, 0
58, 43, 101, Tc, -86344.593, 24.004, 8593.1, 3660, 0
57, 44, 101, Ru, -87958.113, 0.413, 8601.3, 6600, 0
56, 45, 101, Rh, -87412.428, 5.841, 8588.2, 1720, 0
55, 46, 101, Pd, -85432.145, 4.588, 8560.8, 6440, 0
54, 47, 101, Ag, -81334.384, 4.838, 8512.5, 4650, 0
53, 48, 101, Cd, -75836.466, 1.490, 8450.3, 6570, 0
52, 49, 101, In, -68544.901, 11.662, 8370.4, 2600, 0
51, 50, 101, Sn, -60305.624, 300.005, 8281.1, 0302, 0
65, 37, 102, Rb, -37252.312, 82.903, 8152.7, 4430, 0
64, 38, 102, Sr, -52159.311, 67.068, 8291.2, 2130, 0
63, 39, 102, Y, -61172.641, 4.081, 8371.9, 1720, 0
62, 40, 102, Zr, -71581.427, 8.758, 8466.2, 9400, 0
61, 41, 102, Nb, -76298.265, 2.511, 8504.8, 6750, 0
60, 42, 102, Mo, -83560.866, 8.305, 8568.3, 9940, 0
59, 43, 102, Tc, -84572.921, 9.166, 8570.6, 5140, 0
58, 44, 102, Ru, -89106.435, 0.416, 8607.4, 2750, 0
57, 45, 102, Rh, -86783.316, 6.410, 8576.9, 8180, 0
56, 46, 102, Pd, -87902.963, 0.419, 8580.2, 8870, 0
55, 47, 102, Ag, -82246.702, 8.171, 8517.1, 6500, 0
54, 48, 102, Cd, -79659.702, 1.662, 8484.1, 3220, 0
53, 49, 102, In, -70694.896, 4.573, 8388.5, 7190, 0
52, 50, 102, Sn, -64934.896, 100.105, 8324.4, 3130, 0
51, 51, 102, Sb, -51100, 400, 8181, 4, 0
66, 37, 103, Rb, -33160, 400, 8112, 4, 0
65, 38, 103, Sr, -47280, 200, 8242, 2, 0
64, 39, 103, Y, -58457.034, 11.206, 8342.6, 3360, 0
63, 40, 103, Zr, -67808.993, 9.223, 8425.8, 3370, 0
62, 41, 103, Nb, -75028.667, 3.935, 8488.3, 3200, 0
61, 42, 103, Mo, -80954.331, 9.223, 8538.2, 6720, 0
60, 43, 103, Tc, -84603.920, 9.810, 8566.1, 0450, 0
59, 44, 103, Ru, -87267.168, 0.441, 8584.3, 6560, 0
58, 45, 103, Rh, -88031.705, 2.301, 8584.1, 9270, 0
57, 46, 103, Pd, -87456.980, 0.878, 8571.0, 1730, 0
56, 47, 103, Ag, -84802.702, 4.099, 8537.6, 5200, 0
55, 48, 103, Cd, -80651.626, 1.811, 8489.7, 5470, 0
54, 49, 103, In, -74632.397, 8.980, 8423.7, 1990, 0
53, 50, 103, Sn, -67092, 100, 8343, 1, 0
52, 51, 103, Sb, -56670, 300, 8234, 3, 0
67, 37, 104, Rb, -27450, 500, 8057, 5, 0
66, 38, 104, Sr, -43760, 300, 8206, 3, 0
65, 39, 104, Y, -54080, 200, 8298, 2, 0
64, 40, 104, Zr, -65717.660, 9.316, 8402.3, 1590, 0
63, 41, 104, Nb, -71810.997, 1.784, 8453.3, 8320, 0
62, 42, 104, Mo, -80343.748, 8.911, 8527.9, 0630, 0
61, 43, 104, Tc, -82498.969, 24.886, 8541.1, 0700, 0
60, 44, 104, Ru, -88095.763, 2.498, 8587.3, 9980, 0
59, 45, 104, Rh, -86959.344, 2.303, 8568.9, 5010, 0
58, 46, 104, Pd, -89395.123, 1.336, 8584.8, 4850, 0
57, 47, 104, Ag, -85116.470, 4.217, 8536.1, 8500, 0
56, 48, 104, Cd, -83968.391, 1.673, 8517.6, 2320, 0
55, 49, 104, In, -76182.675, 5.775, 8435.2, 3800, 0
54, 50, 104, Sn, -71627.057, 5.745, 8383.9, 1140, 0
53, 51, 104, Sb, -59295, 101, 8258, 1, 0
52, 52, 104, Te, -49626.831, 317.609, 8157.3, 2563, 0
67, 38, 105, Sr, -38190, 500, 8152, 5, 0
66, 39, 105, Y, -50570, 400, 8262, 4, 0
65, 40, 105, Zr, -61458.274, 12.110, 8358.5, 9800, 0
64, 41, 105, Nb, -69915.547, 4.028, 8431.6, 9250, 0
63, 42, 105, Mo, -77330.788, 9.055, 8494.8, 6300, 0
62, 43, 105, Tc, -82286.303, 35.263, 8534.6, 0740, 0
61, 44, 105, Ru, -85934.543, 2.499, 8561.9, 0160, 0
60, 45, 105, Rh, -87851.270, 2.502, 8572.7, 0530, 0
59, 46, 105, Pd, -88417.905, 1.138, 8570.6, 5090, 0
58, 47, 105, Ag, -87070.848, 4.544, 8550.3, 7080, 0
57, 48, 105, Cd, -84333.849, 1.392, 8516.8, 5320, 0
56, 49, 105, In, -79640.582, 10.246, 8464.7, 0450, 0
55, 50, 105, Sn, -73338.001, 3.971, 8397.2, 2900, 0
54, 51, 105, Sb, -64015.491, 21.827, 8300.9, 9230, 0
53, 52, 105, Te, -52811.509, 300.020, 8186.8, 3682, 0
68, 38, 106, Sr, -34300, 600, 8114, 6, 0
67, 39, 106, Y, -45790, 500, 8215, 5, 0
66, 40, 106, Zr, -58749, 200, 8330, 2, 0
65, 41, 106, Nb, -66202.678, 1.416, 8393.2, 6570, 0
64, 42, 106, Mo, -76128.003, 9.130, 8479.5, 2020, 0
63, 43, 106, Tc, -79776.253, 12.250, 8506.5, 5700, 0
62, 44, 106, Ru, -86323.253, 5.391, 8560.9, 4060, 0
61, 45, 106, Rh, -86362.656, 5.390, 8553.9, 3170, 0
60, 46, 106, Pd, -89907.543, 1.106, 8579.9, 9340, 0
59, 47, 106, Ag, -86942.399, 3.016, 8544.6, 3970, 0
58, 48, 106, Cd, -87132.153, 1.104, 8539.0, 4920, 0
57, 49, 106, In, -80608.150, 12.226, 8470.1, 2130, 0
56, 50, 106, Sn, -77353.698, 5.091, 8432.0, 3830, 0
55, 51, 106, Sb, -66473.301, 7.452, 8322.0, 1240, 0
54, 52, 106, Te, -58219.759, 100.541, 8236.7, 6820, 0
53, 53, 106, I, -43300, 400, 8089, 4, 0
69, 38, 107, Sr, -28250, 700, 8057, 7, 0
68, 39, 107, Y, -41970, 500, 8178, 5, 0
67, 40, 107, Zr, -54020, 300, 8284, 3, 0
66, 41, 107, Nb, -63723.805, 8.023, 8367.0, 8980, 0
65, 42, 107, Mo, -72544.975, 9.223, 8442.2, 1900, 0
64, 43, 107, Tc, -78749.967, 8.673, 8492.8, 9790, 0
63, 44, 107, Ru, -83862.565, 8.673, 8533.3, 6760, 0
62, 45, 107, Rh, -86863.711, 12.051, 8554.1, 0400, 0
61, 46, 107, Pd, -88372.654, 1.201, 8560.8, 9460, 0
60, 47, 107, Ag, -88406.700, 2.382, 8553.9, 0120, 0
59, 48, 107, Cd, -86990.325, 1.660, 8533.3, 5240, 0
58, 49, 107, In, -83566.667, 9.654, 8494.0, 4390, 0
57, 50, 107, Sn, -78512.239, 5.310, 8439.4, 9460, 0
56, 51, 107, Sb, -70653.248, 4.148, 8358.7, 3440, 0
55, 52, 107, Te, -60657, 101, 8258, 1, 0
54, 53, 107, I, -49430, 300, 8146, 3, 0
69, 39, 108, Y, -36780, 600, 8129, 6, 0
68, 40, 108, Zr, -50950, 400, 8253, 4, 0
67, 41, 108, Nb, -59545.198, 8.239, 8325.6, 6040, 0
66, 42, 108, Mo, -70749.297, 9.223, 8422.1, 5810, 0
65, 43, 108, Tc, -75922.831, 8.769, 8462.8, 1720, 0
64, 44, 108, Ru, -83661.404, 8.680, 8527.2, 2670, 0
63, 45, 108, Rh, -85031.156, 13.997, 8532.6, 6570, 0
62, 46, 108, Pd, -89524.215, 1.108, 8567.0, 2410, 0
61, 47, 108, Ag, -87606.792, 2.388, 8542.0, 2620, 0
60, 48, 108, Cd, -89252.423, 1.123, 8550.0, 1960, 0
59, 49, 108, In, -84119.828, 8.641, 8495.2, 5160, 0
58, 50, 108, Sn, -82069.949, 5.382, 8469.0, 2730, 0
57, 51, 108, Sb, -72445.341, 5.496, 8372.6, 6660, 0
56, 52, 108, Te, -65781.676, 5.411, 8303.7, 2210, 0
55, 53, 108, I, -52771, 101, 8176, 1, 0
54, 54, 108, Xe, -42632.357, 379.497, 8074.8, 8863, 0
70, 39, 109, Y, -32480, 700, 8089, 6, 0
69, 40, 109, Zr, -45730, 500, 8204, 5, 0
68, 41, 109, Nb, -56689.800, 430.816, 8297.1, 3073, 0
67, 42, 109, Mo, -66659.285, 11.179, 8381.4, 1630, 0
66, 43, 109, Tc, -74282.828, 9.669, 8444.1, 7960, 0
65, 44, 109, Ru, -80738.455, 8.954, 8496.2, 2800, 0
64, 45, 109, Rh, -84999.251, 4.040, 8528.1, 4040, 0
63, 46, 109, Pd, -87606.484, 1.114, 8544.8, 8250, 0
62, 47, 109, Ag, -88719.431, 1.287, 8547.9, 1550, 0
61, 48, 109, Cd, -88504.330, 1.536, 8538.7, 6460, 0
60, 49, 109, In, -86489.526, 3.969, 8513.1, 0270, 0
59, 50, 109, Sn, -82630.180, 7.949, 8470.5, 1830, 0
58, 51, 109, Sb, -76250.986, 5.265, 8404.8, 1610, 0
57, 52, 109, Te, -67715.399, 4.382, 8319.3, 3050, 0
56, 53, 109, I, -57672.505, 6.729, 8220.0, 1640, 0
55, 54, 109, Xe, -46169.546, 300.108, 8107.3, 0712, 0
70, 40, 110, Zr, -42220, 500, 8171, 5, 0
69, 41, 110, Nb, -52309.914, 838.345, 8255.2, 6077, 0
68, 42, 110, Mo, -64535.814, 24.219, 8359.2, 9300, 0
67, 43, 110, Tc, -71034.564, 9.497, 8411.2, 6030, 0
66, 44, 110, Ru, -80072.629, 8.924, 8486.3, 1230, 0
65, 45, 110, Rh, -82828.693, 17.805, 8504.2, 5510, 0
64, 46, 110, Pd, -88330.904, 0.612, 8547.1, 6300, 0
63, 47, 110, Ag, -87457.306, 1.286, 8532.1, 0890, 0
62, 48, 110, Cd, -90347.969, 0.380, 8551.2, 7550, 0
61, 49, 110, In, -86469.969, 11.553, 8508.9, 0870, 0
60, 50, 110, Sn, -85841.993, 13.777, 8496.0, 8750, 0
59, 51, 110, Sb, -77449.745, 5.962, 8412.6, 8210, 0
58, 52, 110, Te, -72229.821, 6.575, 8358.1, 1600, 0
57, 53, 110, I, -60467.844, 61.940, 8244.0, 7670, 0
56, 54, 110, Xe, -51922.636, 100.988, 8159.2, 8080, 0
71, 40, 111, Zr, -36480, 600, 8118, 5, 0
70, 41, 111, Nb, -48960, 300, 8223, 3, 0
69, 42, 111, Mo, -59939.813, 12.578, 8315.2, 9320, 0
68, 43, 111, Tc, -69024.675, 10.582, 8390.0, 9060, 0
67, 44, 111, Ru, -76785.325, 9.682, 8452.9, 5820, 0
66, 45, 111, Rh, -82303.871, 6.853, 8495.6, 2670, 0
65, 46, 111, Pd, -85985.886, 0.731, 8521.7, 4980, 0
64, 47, 111, Ag, -88215.447, 1.459, 8534.7, 8780, 0
63, 48, 111, Cd, -89252.247, 0.357, 8537.0, 8010, 0
62, 49, 111, In, -88392.050, 3.424, 8522.2, 8240, 0
61, 50, 111, Sn, -85938.581, 5.336, 8493.1, 3100, 0
60, 51, 111, Sb, -80836.747, 8.849, 8440.1, 2030, 0
59, 52, 111, Te, -73587.487, 6.427, 8367.7, 6350, 0
58, 53, 111, I, -64953.795, 4.754, 8282.9, 3430, 0
57, 54, 111, Xe, -54520, 115, 8182, 1, 0
56, 55, 111, Cs, -42900, 200, 8070, 2, 0
72, 40, 112, Zr, -32420, 700, 8081, 6, 0
71, 41, 112, Nb, -44070, 300, 8178, 3, 0
70, 42, 112, Mo, -57480, 200, 8291, 2, 0
69, 43, 112, Tc, -65258.932, 5.515, 8353.6, 2170, 0
68, 44, 112, Ru, -75630.873, 9.600, 8439.2, 4310, 0
67, 45, 112, Rh, -79731.052, 44.085, 8468.8, 6660, 0
66, 46, 112, Pd, -86321.039, 6.546, 8520.7, 2050, 0
65, 47, 112, Ag, -86583.729, 2.422, 8516.0, 8070, 0
64, 48, 112, Cd, -90574.857, 0.250, 8544.7, 3060, 0
63, 49, 112, In, -87990.127, 4.251, 8514.6, 6740, 0
62, 50, 112, Sn, -88655.049, 0.294, 8513.6, 1890, 0
61, 51, 112, Sb, -81598.973, 17.829, 8443.6, 3300, 0
60, 52, 112, Te, -77567.518, 8.383, 8400.6, 5270, 0
59, 53, 112, I, -67063.339, 10.246, 8299.8, 8010, 0
58, 54, 112, Xe, -60026.348, 8.283, 8230.0, 6460, 0
57, 55, 112, Cs, -46415, 116, 8102, 1, 0
73, 40, 113, Zr, -26340, 300, 8027, 3, 0
72, 41, 113, Nb, -40210, 400, 8143, 4, 0
71, 42, 113, Mo, -52650, 300, 8246, 3, 0
70, 43, 113, Tc, -62811.549, 3.353, 8329.4, 6520, 0
69, 44, 113, Ru, -71867.816, 38.282, 8402.6, 8570, 0
68, 45, 113, Rh, -78766.944, 7.132, 8456.8, 1650, 0
67, 46, 113, Pd, -83590.500, 6.947, 8492.5, 7950, 0
66, 47, 113, Ag, -87026.825, 16.643, 8516.0, 6600, 0
65, 48, 113, Cd, -89043.286, 0.245, 8526.9, 8740, 0
64, 49, 113, In, -89367.123, 0.188, 8522.9, 2970, 0
63, 50, 113, Sn, -88328.129, 1.575, 8506.8, 1170, 0
62, 51, 113, Sb, -84416.966, 17.193, 8465.2, 7620, 0
61, 52, 113, Te, -78347.037, 27.945, 8404.6, 3660, 0
60, 53, 113, I, -71119.517, 8.011, 8333.7, 5280, 0
59, 54, 113, Xe, -62203.626, 6.840, 8247.9, 2770, 0
58, 55, 113, Cs, -51764.539, 8.577, 8148.6, 2300, 0
57, 56, 113, Ba, -39710, 300, 8035, 3, 0
73, 41, 114, Nb, -34960, 500, 8097, 4, 0
72, 42, 114, Mo, -49680, 300, 8219, 3, 0
71, 43, 114, Tc, -58600.294, 433.145, 8290.2, 5993, 0
70, 44, 114, Ru, -70221.213, 3.556, 8385.3, 3510, 0
69, 45, 114, Rh, -75710.275, 71.561, 8426.6, 2210, 0
68, 46, 114, Pd, -83490.346, 6.948, 8488.0, 0560, 0
67, 47, 114, Ag, -84930.811, 4.564, 8493.7, 7860, 0
66, 48, 114, Cd, -90014.934, 0.276, 8531.5, 1350, 0
65, 49, 114, In, -88569.807, 0.301, 8511.9, 7420, 0
64, 50, 114, Sn, -90559.735, 0.029, 8522.5, 6710, 0
63, 51, 114, Sb, -84496.616, 19.772, 8462.5, 1910, 0
62, 52, 114, Te, -81889.676, 24.428, 8432.7, 8850, 0
61, 53, 114, I, -72638.935, 20.027, 8344.7, 7900, 0
60, 54, 114, Xe, -67085.899, 11.178, 8289.2, 0540, 0
59, 55, 114, Cs, -54685.928, 85.068, 8173.5, 7110, 0
58, 56, 114, Ba, -45905.437, 102.676, 8089.6, 8650, 0
74, 41, 115, Nb, -30880, 500, 8061, 4, 0
73, 42, 115, Mo, -44550, 400, 8173, 3, 0
72, 43, 115, Tc, -55796, 196, 8264, 2, 0
71, 44, 115, Ru, -66105.296, 25.166, 8346.8, 1400, 0
70, 45, 115, Rh, -74229.228, 7.319, 8410.6, 5380, 0
69, 46, 115, Pd, -80425.822, 13.547, 8457.7, 3420, 0
68, 47, 115, Ag, -84982.587, 18.268, 8490.5, 5530, 0
67, 48, 115, Cd, -88084.480, 0.651, 8510.7, 2520, 0
66, 49, 115, In, -89536.357, 0.012, 8516.5, 4720, 0
65, 50, 115, Sn, -90033.846, 0.015, 8514.0, 7020, 0
64, 51, 115, Sb, -87003.412, 16.025, 8480.9, 1560, 0
63, 52, 115, Te, -82062.767, 27.945, 8431.1, 5040, 0
62, 53, 115, I, -76337.805, 28.876, 8374.5, 6510, 0
61, 54, 115, Xe, -68656.757, 12.109, 8300.9, 7040, 0
60, 55, 115, Cs, -59699, 102, 8216, 1, 0
59, 56, 115, Ba, -48920, 200, 8116, 2, 0
75, 41, 116, Nb, -25230, 300, 8012, 3, 0
74, 42, 116, Mo, -41210, 500, 8143, 4, 0
73, 43, 116, Tc, -51214, 298, 8223, 3, 0
72, 44, 116, Ru, -64068.917, 3.726, 8326.8, 8400, 0
71, 45, 116, Rh, -70735.742, 73.832, 8377.6, 1230, 0
70, 46, 116, Pd, -79831.026, 7.135, 8449.2, 7550, 0
69, 47, 116, Ag, -82542.664, 3.260, 8465.9, 0730, 0
68, 48, 116, Cd, -88712.489, 0.160, 8512.3, 5110, 0
67, 49, 116, In, -88249.758, 0.220, 8501.6, 1770, 0
66, 50, 116, Sn, -91525.979, 0.096, 8523.1, 1660, 0
65, 51, 116, Sb, -86822.020, 5.154, 8475.8, 2080, 0
64, 52, 116, Te, -85263.793, 24.206, 8455.6, 4350, 0
63, 53, 116, I, -77420.654, 75.037, 8381.2, 8580, 0
62, 54, 116, Xe, -73046.877, 13.017, 8336.8, 3650, 0
61, 55, 116, Cs, -62043, 100, 8235, 1, 0
60, 56, 116, Ba, -54380, 200, 8162, 2, 0
59, 57, 116, La, -40050, 321, 8032, 3, 0
75, 42, 117, Mo, -35689, 500, 8096, 4, 0
74, 43, 117, Tc, -48140, 400, 8195, 3, 0
73, 44, 117, Ru, -59489.871, 433.145, 8285.5, 6253, 0
72, 45, 117, Rh, -68896.758, 8.895, 8359.2, 7660, 0
71, 46, 117, Pd, -76423.890, 7.255, 8416.9, 2430, 0
70, 47, 117, Ag, -82181.918, 13.572, 8459.4, 5150, 0
69, 48, 117, Cd, -86418.397, 1.013, 8488.9, 7400, 0
68, 49, 117, In, -88943.035, 4.881, 8503.8, 6530, 0
67, 50, 117, Sn, -90397.742, 0.483, 8509.6, 1200, 0
66, 51, 117, Sb, -88639.564, 8.437, 8487.8, 9810, 0
65, 52, 117, Te, -85095.500, 13.455, 8450.9, 2030, 0
64, 53, 117, I, -80438.568, 25.558, 8404.4, 3070, 0
63, 54, 117, Xe, -74185.347, 10.378, 8344.2, 9760, 0
62, 55, 117, Cs, -66493.101, 62.410, 8271.8, 6520, 0
61, 56, 117, Ba, -57457.906, 250.339, 8187.9, 5462, 0
60, 57, 117, La, -46271, 200, 8086, 2, 0
76, 42, 118, Mo, -32370, 500, 8067, 4, 0
75, 43, 118, Tc, -43290, 400, 8153, 3, 0
74, 44, 118, Ru, -57000, 200, 8263, 2, 0
73, 45, 118, Rh, -64886.840, 24.236, 8322.8, 5390, 0
72, 46, 118, Pd, -75388.358, 2.494, 8405.2, 1970, 0
71, 47, 118, Ag, -79553.802, 2.515, 8433.8, 9000, 0
70, 48, 118, Cd, -86701.649, 20.001, 8487.8, 3500, 0
69, 49, 118, In, -87228.177, 7.752, 8485.6, 6700, 0
68, 50, 118, Sn, -91652.843, 0.499, 8516.5, 3410, 0
67, 51, 118, Sb, -87996.204, 3.016, 8478.9, 1560, 0
66, 52, 118, Te, -87690.758, 18.306, 8469.6, 9700, 0
65, 53, 118, I, -80971.056, 19.760, 8406.1, 2030, 0
64, 54, 118, Xe, -78079.067, 10.378, 8374.9, 8190, 0
63, 55, 118, Cs, -68409.377, 12.753, 8286.4, 0530, 0
62, 56, 118, Ba, -62200, 200, 8227, 2, 0
61, 57, 118, La, -49620, 300, 8114, 3, 0
77, 42, 119, Mo, -26580, 300, 8019, 3, 0
76, 43, 119, Tc, -40170, 500, 8126, 4, 0
75, 44, 119, Ru, -52080, 300, 8220, 3, 0
74, 45, 119, Rh, -62822.802, 9.315, 8303.3, 9530, 0
73, 46, 119, Pd, -71407.277, 8.248, 8368.9, 5940, 0
72, 47, 119, Ag, -78645.759, 14.703, 8423.2, 1260, 0
71, 48, 119, Cd, -83976.939, 37.695, 8461.4, 3810, 0
70, 49, 119, In, -87698.658, 7.310, 8486.1, 3870, 0
69, 50, 119, Sn, -90064.985, 0.725, 8499.4, 4940, 0
68, 51, 119, Sb, -89475.539, 6.998, 8487.9, 2180, 0
67, 52, 119, Te, -87182.539, 7.278, 8462.0, 7850, 0
66, 53, 119, I, -83777.731, 21.706, 8426.8, 9240, 0
65, 54, 119, Xe, -78794.488, 10.378, 8378.4, 4200, 0
64, 55, 119, Cs, -72305.061, 13.940, 8317.3, 3470, 0
63, 56, 119, Ba, -64590.096, 200.269, 8245.9, 2871, 0
62, 57, 119, La, -55020, 300, 8159, 3, 0
61, 58, 119, Ce, -43820, 500, 8058, 4, 0
77, 43, 120, Tc, -35000, 500, 8083, 4, 0
76, 44, 120, Ru, -49720, 400, 8199, 3, 0
75, 45, 120, Rh, -58620, 200, 8266, 2, 0
74, 46, 120, Pd, -70279.604, 2.296, 8357.0, 8170, 0
73, 47, 120, Ag, -75651.512, 4.471, 8395.3, 2810, 0
72, 48, 120, Cd, -83957.365, 3.726, 8458.0, 2400, 0
71, 49, 120, In, -85727.741, 40.011, 8466.2, 5750, 0
70, 50, 120, Sn, -91097.741, 0.920, 8504.4, 8800, 0
69, 51, 120, Sb, -88417.133, 7.199, 8475.6, 3000, 0
68, 52, 120, Te, -89362.160, 1.751, 8476.9, 8570, 0
67, 53, 120, I, -83747.160, 15.102, 8423.6, 7450, 0
66, 54, 120, Xe, -82172.434, 11.817, 8404.0, 3220, 0
65, 55, 120, Cs, -73888.649, 9.970, 8328.4, 8110, 0
64, 56, 120, Ba, -68888.649, 300.166, 8280.2, 9492, 0
63, 57, 120, La, -57570, 300, 8179, 2, 0
62, 58, 120, Ce, -49730, 500, 8108, 4, 0
78, 43, 121, Tc, -31540, 500, 8054, 4, 0
77, 44, 121, Ru, -44620, 400, 8156, 3, 0
76, 45, 121, Rh, -56250.134, 619.444, 8245.2, 3975, 0
75, 46, 121, Pd, -66182.337, 3.353, 8320.8, 5840, 0
74, 47, 121, Ag, -74402.831, 12.109, 8382.3, 3060, 0
73, 48, 121, Cd, -81073.837, 1.942, 8430.9, 9720, 0
72, 49, 121, In, -85834.593, 27.419, 8463.8, 7670, 0
71, 50, 121, Sn, -89196.626, 0.978, 8485.1, 9640, 0
70, 51, 121, Sb, -89599.157, 2.506, 8482.0, 5740, 0
69, 52, 121, Te, -88543.111, 25.835, 8466.8, 6410, 0
68, 53, 121, I, -86245.649, 4.723, 8441.4, 1110, 0
67, 54, 121, Xe, -82480.997, 10.243, 8403.8, 3260, 0
66, 55, 121, Cs, -77102.342, 14.290, 8352.9, 1520, 0
65, 56, 121, Ba, -70744.847, 141.898, 8293.9, 0831, 0
64, 57, 121, La, -62190, 300, 8217, 2, 0
63, 58, 121, Ce, -52690, 401, 8132, 3, 0
62, 59, 121, Pr, -41551, 500, 8033, 4, 0
79, 43, 122, Tc, -26305, 300, 8011, 2, 0
78, 44, 122, Ru, -41780, 500, 8132, 4, 0
77, 45, 122, Rh, -51880, 300, 8208, 2, 0
76, 46, 122, Pd, -64616.169, 19.561, 8305.9, 7550, 0
75, 47, 122, Ag, -71106.118, 38.191, 8352.7, 5910, 0
74, 48, 122, Cd, -80612.384, 2.299, 8424.2, 6670, 0
73, 49, 122, In, -83571.361, 50.060, 8442.1, 0790, 0
72, 50, 122, Sn, -89939.953, 2.448, 8487.8, 9680, 0
71, 51, 122, Sb, -88334.205, 2.503, 8468.3, 2220, 0
70, 52, 122, Te, -90313.282, 1.357, 8478.1, 3150, 0
69, 53, 122, I, -86079.282, 5.181, 8437.0, 1390, 0
68, 54, 122, Xe, -85354.988, 11.111, 8424.6, 6440, 0
67, 55, 122, Cs, -78144.769, 33.687, 8359.1, 5150, 0
66, 56, 122, Ba, -74608.952, 27.945, 8323.7, 5670, 0
65, 57, 122, La, -64543, 298, 8235, 2, 0
64, 58, 122, Ce, -57874, 401, 8174, 3, 0
63, 59, 122, Pr, -44780, 500, 8060, 4, 0
79, 44, 123, Ru, -36550, 500, 8089, 4, 0
78, 45, 123, Rh, -49190, 400, 8185, 3, 0
77, 46, 123, Pd, -60429.748, 789.441, 8270.0, 3186, 0
76, 47, 123, Ag, -69568.581, 32.602, 8337.9, 7070, 0
75, 48, 123, Cd, -77414.183, 2.696, 8395.3, 9550, 0
74, 49, 123, In, -83429.034, 19.832, 8437.9, 3620, 0
73, 50, 123, Sn, -87814.683, 2.479, 8467.2, 3130, 0
72, 51, 123, Sb, -89222.890, 1.356, 8472.3, 1960, 0
71, 52, 123, Te, -89170.978, 1.355, 8465.5, 3700, 0
70, 53, 123, I, -87942.588, 3.686, 8449.1, 8960, 0
69, 54, 123, Xe, -85248.258, 9.534, 8420.9, 2390, 0
68, 55, 123, Cs, -81043.657, 12.109, 8380.3, 7960, 0
67, 56, 123, Ba, -75654.963, 12.109, 8330.2, 0860, 0
66, 57, 123, La, -68651, 196, 8267, 2, 0
65, 58, 123, Ce, -60286, 298, 8193, 2, 0
64, 59, 123, Pr, -50230, 400, 8104, 3, 0
80, 44, 124, Ru, -33590, 600, 8065, 5, 0
79, 45, 124, Rh, -44710, 400, 8148, 3, 0
78, 46, 124, Pd, -58400, 300, 8252, 2, 0
77, 47, 124, Ag, -66229.951, 251.503, 8308.8, 9582, 0
76, 48, 124, Cd, -76699.436, 2.609, 8387.0, 1790, 0
75, 49, 124, In, -80867.778, 30.561, 8414.3, 2430, 0
74, 50, 124, Sn, -88231.475, 1.314, 8467.3, 9970, 0
73, 51, 124, Sb, -87619.069, 1.358, 8456.1, 5170, 0
72, 52, 124, Te, -90524.142, 1.352, 8473.2, 7050, 0
71, 53, 124, I, -87364.555, 2.299, 8441.4, 8070, 0
70, 54, 124, Xe, -87667.405, 1.358, 8437.6, 1380, 0
69, 55, 124, Cs, -81741.060, 9.151, 8383.5, 1140, 0
68, 56, 124, Ba, -79089.786, 12.497, 8355.8, 2090, 0
67, 57, 124, La, -70258.617, 56.669, 8278.2, 9260, 0
66, 58, 124, Ce, -64916, 298, 8229, 2, 0
65, 59, 124, Pr, -53151, 401, 8128, 3, 0
64, 60, 124, Nd, -44830, 500, 8054, 4, 0
81, 44, 125, Ru, -28370, 300, 8023, 2, 0
80, 45, 125, Rh, -41830, 500, 8124, 4, 0
79, 46, 125, Pd, -53960, 400, 8215, 3, 0
78, 47, 125, Ag, -64519.939, 433.145, 8293.3, 1513, 0
77, 48, 125, Cd, -73348.090, 2.888, 8357.6, 8150, 0
76, 49, 125, In, -80412.308, 1.770, 8407.9, 3650, 0
75, 50, 125, Sn, -85893.657, 1.329, 8445.5, 2850, 0
74, 51, 125, Sb, -88255.094, 2.515, 8458.1, 6120, 0
73, 52, 125, Te, -89021.794, 1.352, 8458.0, 3610, 0
72, 53, 125, I, -88836.024, 1.353, 8450.2, 9110, 0
71, 54, 125, Xe, -87199.361, 1.415, 8430.9, 3900, 0
70, 55, 125, Cs, -84089.742, 7.736, 8399.8, 0330, 0
69, 56, 125, Ba, -79668.976, 10.992, 8358.1, 7840, 0
68, 57, 125, La, -73759.492, 25.997, 8304.6, 4380, 0
67, 58, 125, Ce, -66658, 196, 8242, 2, 0
66, 59, 125, Pr, -58070, 300, 8167, 2, 0
65, 60, 125, Nd, -48070, 400, 8080, 3, 0
81, 45, 126, Rh, -37200, 500, 8087, 4, 0
80, 46, 126, Pd, -51790, 400, 8197, 3, 0
79, 47, 126, Ag, -60720, 200, 8261, 2, 0
78, 48, 126, Cd, -72255.727, 2.304, 8346.7, 3930, 0
77, 49, 126, In, -77809.377, 4.192, 8384.6, 0670, 0
76, 50, 126, Sn, -86015.135, 10.688, 8443.5, 2270, 0
75, 51, 126, Sb, -86393.135, 31.847, 8440.3, 1360, 0
74, 52, 126, Te, -90064.168, 1.354, 8463.2, 3970, 0
73, 53, 126, I, -87910.496, 3.778, 8439.9, 3790, 0
72, 54, 126, Xe, -89146.38687, 0.0056, 28443.5, 3750, 0
71, 55, 126, Cs, -84350.683, 10.359, 8399.2, 6730, 0
70, 56, 126, Ba, -82669.913, 12.497, 8379.7, 1870, 0
69, 57, 126, La, -74973.476, 90.508, 8312.4, 2680, 0
68, 58, 126, Ce, -70820.565, 27.945, 8273.2, 5810, 0
67, 59, 126, Pr, -60324, 196, 8184, 2, 0
66, 60, 126, Nd, -53380, 300, 8122, 2, 0
65, 61, 126, Pm, -39750, 500, 8008, 4, 0
82, 45, 127, Rh, -33730, 600, 8060, 5, 0
81, 46, 127, Pd, -47220, 500, 8160, 4, 0
80, 47, 127, Ag, -58650, 200, 8244, 2, 0
79, 48, 127, Cd, -68741.199, 6.200, 8316.8, 9710, 0
78, 49, 127, In, -76879.897, 10.001, 8374.8, 2120, 0
77, 50, 127, Sn, -83469.578, 9.226, 8420.5, 4820, 0
76, 51, 127, Sb, -86698.294, 5.083, 8439.8, 1100, 0
75, 52, 127, Te, -88280.497, 1.365, 8446.1, 0900, 0
74, 53, 127, I, -88983.217, 3.621, 8445.4, 8200, 0
73, 54, 127, Xe, -88320.883, 4.088, 8434.1, 0660, 0
72, 55, 127, Cs, -86240.027, 5.578, 8411.5, 6170, 0
71, 56, 127, Ba, -82817.955, 11.357, 8378.4, 5600, 0
70, 57, 127, La, -77896.116, 26.000, 8333.5, 4120, 0
69, 58, 127, Ce, -71979.344, 28.876, 8280.7, 9220, 0
68, 59, 127, Pr, -64543, 196, 8216, 2, 0
67, 60, 127, Nd, -55910, 300, 8142, 2, 0
66, 61, 127, Pm, -45310, 400, 8052, 3, 0
83, 45, 128, Rh, -27340, 300, 8010, 2, 0
82, 46, 128, Pd, -44390, 500, 8137, 4, 0
81, 47, 128, Ag, -54710, 300, 8211, 2, 0
80, 48, 128, Cd, -67238.245, 6.432, 8303.2, 3670, 0
79, 49, 128, In, -74190.117, 1.322, 8351.4, 3610, 0
78, 50, 128, Sn, -83361.430, 17.682, 8416.9, 7490, 0
77, 51, 128, Sb, -84629.852, 18.788, 8420.7, 7240, 0
76, 52, 128, Te, -88993.794, 0.706, 8448.7, 5360, 0
75, 53, 128, I, -87738.030, 3.621, 8432.8, 3090, 0
74, 54, 128, Xe, -89860.53427, 0.0052, 08443.3, 0080, 0
73, 55, 128, Cs, -85931.773, 5.376, 8406.4, 9530, 0
72, 56, 128, Ba, -85369.156, 1.610, 8395.9, 8780, 0
71, 57, 128, La, -78625.439, 54.448, 8337.1, 9040, 0
70, 58, 128, Ce, -75533.925, 27.945, 8306.9, 2590, 0
69, 59, 128, Pr, -66330.764, 29.808, 8228.9, 1410, 0
68, 60, 128, Nd, -60530, 200, 8177, 2, 0
67, 61, 128, Pm, -48220, 300, 8075, 2, 0
66, 62, 128, Sm, -39150, 500, 7998, 4, 0
83, 46, 129, Pd, -37880, 600, 8086, 5, 0
82, 47, 129, Ag, -51870, 400, 8188, 3, 0
81, 48, 129, Cd, -63122.142, 5.310, 8269.5, 3110, 0
80, 49, 129, In, -72834.889, 1.971, 8338.7, 5900, 0
79, 50, 129, Sn, -80590.597, 17.270, 8392.8, 1610, 0
78, 51, 129, Sb, -84629.384, 21.225, 8418.0, 5980, 0
77, 52, 129, Te, -87004.884, 0.711, 8430.4, 0980, 0
76, 53, 129, I, -88507.176, 3.153, 8435.9, 9080, 0
75, 54, 129, Xe, -88696.06975, 0.0050, 58431.3, 9040, 0
74, 55, 129, Cs, -87499.050, 4.553, 8416.0, 4650, 0
73, 56, 129, Ba, -85060.866, 10.504, 8391.0, 8110, 0
72, 57, 129, La, -81323.541, 21.343, 8356.0, 4490, 0
71, 58, 129, Ce, -76287.504, 27.945, 8310.9, 4110, 0
70, 59, 129, Pr, -69773.566, 29.808, 8254.3, 8080, 0
69, 60, 129, Nd, -62375, 202, 8191, 2, 0
68, 61, 129, Pm, -53180, 300, 8114, 2, 0
67, 62, 129, Sm, -42330, 500, 8023, 4, 0
84, 46, 130, Pd, -32730, 300, 8046, 2, 0
83, 47, 130, Ag, -45898, 424, 8142, 3, 0
82, 48, 130, Cd, -61117.597, 22.356, 8252.5, 8680, 0
81, 49, 130, In, -69906.530, 1.790, 8314.1, 7600, 0
80, 50, 130, Sn, -80132.217, 1.873, 8386.8, 1700, 0
79, 51, 130, Sb, -82285.687, 14.212, 8397.3, 6410, 0
78, 52, 130, Te, -87352.960, 0.011, 8430.3, 2510, 0
77, 53, 130, I, -86936.188, 3.154, 8421.1, 0110, 0
76, 54, 130, Xe, -89880.474, 0.009, 8437.7, 3140, 0
75, 55, 130, Cs, -86899.754, 8.357, 8408.7, 8480, 0
74, 56, 130, Ba, -87256.776, 0.287, 8405.5, 1300, 0
73, 57, 130, La, -81627.374, 25.946, 8356.1, 9190, 0
72, 58, 130, Ce, -79422.913, 27.945, 8333.2, 1640, 0
71, 59, 130, Pr, -71175.464, 64.273, 8263.7, 5650, 0
70, 60, 130, Nd, -66596.239, 27.945, 8222.5, 1360, 0
69, 61, 130, Pm, -55470, 200, 8131, 2, 0
68, 62, 130, Sm, -47700, 400, 8065, 3, 0
67, 63, 130, Eu, -33513, 539, 7950, 4, 0
85, 46, 131, Pd, -25740, 300, 7993, 2, 0
84, 47, 131, Ag, -40750, 500, 8102, 4, 0
83, 48, 131, Cd, -55211.760, 19.238, 8206.1, 2040, 0
82, 49, 131, In, -68024.369, 2.205, 8297.9, 5440, 0
81, 50, 131, Sn, -77264.579, 3.621, 8362.5, 1830, 0
80, 51, 131, Sb, -81981.412, 2.084, 8392.5, 5250, 0
79, 52, 131, Te, -85211.022, 0.061, 8411.2, 3390, 0
78, 53, 131, I, -87442.727, 0.605, 8422.2, 9770, 0
77, 54, 131, Xe, -88413.57492, 0.0051, 28423.7, 3670, 0
76, 55, 131, Cs, -88055.574, 0.177, 8415.0, 3170, 0
75, 56, 131, Ba, -86678.958, 0.415, 8398.5, 5110, 0
74, 57, 131, La, -83769.265, 27.945, 8370.3, 6760, 0
73, 58, 131, Ce, -79708.448, 32.802, 8333.3, 9690, 0
72, 59, 131, Pr, -74300.664, 46.995, 8286.1, 4390, 0
71, 60, 131, Nd, -67768.040, 27.517, 8230.3, 0450, 0
70, 61, 131, Pm, -59770, 200, 8163, 2, 0
69, 62, 131, Sm, -50280, 400, 8085, 3, 0
68, 63, 131, Eu, -39464, 400, 7996, 3, 0
85, 47, 132, Ag, -34400, 500, 8053, 4, 0
84, 48, 132, Cd, -50465.429, 60.068, 8169.1, 4210, 0
83, 49, 132, In, -62411.554, 60.033, 8253.7, 1620, 0
82, 50, 132, Sn, -76546.554, 1.976, 8354.8, 7260, 0
81, 51, 132, Sb, -79635.282, 2.467, 8372.3, 4520, 0
80, 52, 132, Te, -85188.197, 3.486, 8408.4, 8590, 0
79, 53, 132, I, -85703.502, 4.065, 8406.4, 6280, 0
78, 54, 132, Xe, -89278.97451, 0.0050, 78427.6, 2290, 0
77, 55, 132, Cs, -87152.693, 1.036, 8405.5, 8780, 0
76, 56, 132, Ba, -88434.903, 1.053, 8409.3, 7470, 0
75, 57, 132, La, -83723.578, 36.359, 8367.7, 5590, 0
74, 58, 132, Ce, -82468.688, 20.407, 8352.3, 2230, 0
73, 59, 132, Pr, -75227.464, 28.876, 8291.5, 3770, 0
72, 60, 132, Nd, -71425.815, 24.205, 8256.8, 1040, 0
71, 61, 132, Pm, -61628, 149, 8177, 1, 0
70, 62, 132, Sm, -55140, 300, 8122, 2, 0
69, 63, 132, Eu, -42200, 400, 8018, 3, 0
86, 47, 133, Ag, -29080, 500, 8013, 4, 0
85, 48, 133, Cd, -44140, 200, 8121, 2, 0
84, 49, 133, In, -57690, 200, 8217, 2, 0
83, 50, 133, Sn, -70873.890, 1.904, 8310.0, 8900, 0
82, 51, 133, Sb, -78923.513, 3.128, 8364.7, 3020, 0
81, 52, 133, Te, -82937.133, 2.066, 8389.0, 2550, 0
80, 53, 133, I, -85857.302, 5.902, 8405.0, 9930, 0
79, 54, 133, Xe, -87643.583, 2.400, 8412.6, 4770, 0
78, 55, 133, Cs, -88070.943, 0.008, 8409.9, 7860, 0
77, 56, 133, Ba, -87553.512, 0.992, 8400.2, 0590, 0
76, 57, 133, La, -85494.392, 27.945, 8378.8, 4150, 0
75, 58, 133, Ce, -82418.223, 16.354, 8349.8, 3010, 0
74, 59, 133, Pr, -77937.591, 12.497, 8310.2, 5880, 0
73, 60, 133, Nd, -72332.380, 46.575, 8262.2, 3200, 0
72, 61, 133, Pm, -65407.653, 50.301, 8204.2, 8410, 0
71, 62, 133, Sm, -57231, 298, 8137, 2, 0
70, 63, 133, Eu, -47236, 298, 8056, 2, 0
69, 64, 133, Gd, -36060, 500, 7966, 4, 0
86, 48, 134, Cd, -39460, 300, 8086, 2, 0
85, 49, 134, In, -51970, 200, 8173, 1, 0
84, 50, 134, Sn, -66433.759, 3.167, 8275.1, 7190, 0
83, 51, 134, Sb, -74019.004, 3.074, 8325.9, 3980, 0
82, 52, 134, Te, -82533.752, 2.746, 8383.6, 4420, 0
81, 53, 134, I, -84043.440, 4.857, 8389.0, 7220, 0
80, 54, 134, Xe, -88125.83443, 0.0057, 78413.6, 9940, 0
79, 55, 134, Cs, -86891.165, 0.016, 8398.6, 4700, 0
78, 56, 134, Ba, -88950.002, 0.251, 8408.1, 7310, 0
77, 57, 134, La, -85218.659, 19.930, 8374.4, 8880, 0
76, 58, 134, Ce, -84832.898, 20.387, 8365.7, 7160, 0
75, 59, 134, Pr, -78528.000, 20.316, 8312.8, 8170, 0
74, 60, 134, Nd, -75646.443, 11.817, 8285.5, 3910, 0
73, 61, 134, Pm, -66763.908, 41.917, 8213.4, 1310, 0
72, 62, 134, Sm, -61376, 196, 8167, 1, 0
71, 63, 134, Eu, -49800, 300, 8075, 2, 0
70, 64, 134, Gd, -41530, 400, 8008, 3, 0
87, 48, 135, Cd, -32820, 400, 8036, 3, 0
86, 49, 135, In, -47110, 300, 8136, 2, 0
85, 50, 135, Sn, -60632.252, 3.074, 8230.6, 8770, 0
84, 51, 135, Sb, -69690.332, 2.640, 8291.9, 8940, 0
83, 52, 135, Te, -77728.790, 1.722, 8345.7, 3840, 0
82, 53, 135, I, -83779.180, 2.060, 8384.7, 6090, 0
81, 54, 135, Xe, -86413.365, 3.668, 8398.4, 7830, 0
80, 55, 135, Cs, -87581.956, 0.364, 8401.3, 3930, 0
79, 56, 135, Ba, -87850.655, 0.245, 8397.5, 3450, 0
78, 57, 135, La, -86643.458, 9.432, 8382.7, 9720, 0
77, 58, 135, Ce, -84616.308, 10.266, 8361.9, 8610, 0
76, 59, 135, Pr, -80935.872, 11.817, 8328.9, 2840, 0
75, 60, 135, Nd, -76213.620, 19.128, 8288.1, 5360, 0
74, 61, 135, Pm, -70062.329, 82.903, 8236.7, 9330, 0
73, 62, 135, Sm, -62857.222, 154.628, 8177.6, 2701, 0
72, 63, 135, Eu, -54148, 196, 8107, 1, 0
71, 64, 135, Gd, -44250, 400, 8028, 3, 0
70, 65, 135, Tb, -33053, 400, 7939, 3, 0
87, 49, 136, In, -40970, 300, 8091, 2, 0
86, 50, 136, Sn, -56170, 200, 8197, 1, 0
85, 51, 136, Sb, -64506.890, 5.830, 8252.2, 5330, 0
84, 52, 136, Te, -74425.279, 2.281, 8319.4, 3010, 0
83, 53, 136, I, -79545.225, 14.188, 8351.3, 2420, 0
82, 54, 136, Xe, -86429.170, 0.007, 8396.1, 8890, 0
81, 55, 136, Cs, -86338.855, 1.873, 8389.7, 7230, 0
80, 56, 136, Ba, -88887.079, 0.245, 8402.7, 5660, 0
79, 57, 136, La, -86037.488, 53.171, 8376.0, 5120, 0
78, 58, 136, Ce, -86508.550, 0.324, 8373.7, 6240, 0
77, 59, 136, Pr, -81340.421, 11.455, 8330.0, 0890, 0
76, 60, 136, Nd, -79199.297, 11.817, 8308.5, 1270, 0
75, 61, 136, Pm, -71169.923, 69.073, 8243.7, 2070, 0
74, 62, 136, Sm, -66810.899, 12.497, 8205.9, 1650, 0
73, 63, 136, Eu, -56244, 196, 8122, 1, 0
72, 64, 136, Gd, -49090, 298, 8064, 2, 0
71, 65, 136, Tb, -35900, 500, 7961, 4, 0
88, 49, 137, In, -35830, 400, 8053, 3, 0
87, 50, 137, Sn, -50150, 300, 8152, 2, 0
86, 51, 137, Sb, -60060.392, 52.164, 8218.4, 7640, 0
85, 52, 137, Te, -69303.762, 2.100, 8280.2, 3570, 0
84, 53, 137, I, -76356.268, 8.383, 8326.0, 0330, 0
83, 54, 137, Xe, -82383.414, 0.104, 8364.2, 8650, 0
82, 55, 137, Cs, -86545.772, 0.302, 8388.9, 5810, 0
81, 56, 137, Ba, -87721.401, 0.248, 8391.8, 2880, 0
80, 57, 137, La, -87140.865, 1.640, 8381.8, 8070, 0
79, 58, 137, Ce, -85918.765, 0.360, 8367.2, 4970, 0
78, 59, 137, Pr, -83201.814, 8.135, 8341.7, 0740, 0
77, 60, 137, Nd, -79583.969, 11.725, 8309.5, 8920, 0
76, 61, 137, Pm, -74072.858, 13.041, 8263.6, 5160, 0
75, 62, 137, Sm, -67991.655, 28.614, 8213.5, 5270, 0
74, 63, 137, Eu, -60145.904, 4.378, 8150.5, 7380, 0
73, 64, 137, Gd, -51214, 298, 8080, 2, 0
72, 65, 137, Tb, -40967, 401, 7999, 3, 0
88, 50, 138, Sn, -45510, 400, 8118, 3, 0
87, 51, 138, Sb, -54650, 300, 8178, 2, 0
86, 52, 138, Te, -65695.995, 3.787, 8252.5, 7860, 0
85, 53, 138, I, -71979.910, 5.962, 8292.4, 4500, 0
84, 54, 138, Xe, -79972.244, 2.804, 8344.6, 9130, 0
83, 55, 138, Cs, -82887.028, 9.158, 8360.1, 4370, 0
82, 56, 138, Ba, -88261.806, 0.249, 8393.4, 2220, 0
81, 57, 138, La, -86513.408, 0.416, 8375.0, 8350, 0
80, 58, 138, Ce, -87565.867, 0.499, 8377.0, 4080, 0
79, 59, 138, Pr, -83128.867, 10.012, 8339.2, 1950, 0
78, 60, 138, Nd, -82017.182, 11.603, 8325.4, 9460, 0
77, 61, 138, Pm, -74914.370, 11.603, 8268.3, 5580, 0
76, 62, 138, Sm, -71497.772, 11.817, 8237.9, 2860, 0
75, 63, 138, Eu, -61749.676, 27.945, 8161.6, 2110, 0
74, 64, 138, Gd, -55660, 200, 8112, 1, 0
73, 65, 138, Tb, -43600, 300, 8019, 2, 0
72, 66, 138, Dy, -34931, 503, 7950, 4, 0
89, 50, 139, Sn, -39310, 400, 8073, 3, 0
88, 51, 139, Sb, -50050, 400, 8144, 3, 0
87, 52, 139, Te, -60205.080, 3.540, 8211.7, 7160, 0
86, 53, 139, I, -68470.964, 4.005, 8265.6, 1000, 0
85, 54, 139, Xe, -75644.586, 2.142, 8311.5, 9040, 0
84, 55, 139, Cs, -80701.088, 3.134, 8342.3, 3970, 0
83, 56, 139, Ba, -84913.918, 0.253, 8367.0, 1940, 0
82, 57, 139, La, -87222.381, 0.607, 8377.9, 9870, 0
81, 58, 139, Ce, -86957.741, 2.089, 8370.4, 6640, 0
80, 59, 139, Pr, -84828.652, 3.649, 8349.5, 2080, 0
79, 60, 139, Nd, -82016.930, 27.521, 8323.6, 6420, 0
78, 61, 139, Pm, -77501.028, 13.588, 8285.5, 4730, 0
77, 62, 139, Sm, -72380.229, 10.884, 8243.0, 7860, 0
76, 63, 139, Eu, -65398.051, 13.151, 8187.2, 1870, 0
75, 64, 139, Gd, -57632, 196, 8126, 1, 0
74, 65, 139, Tb, -48130, 298, 8052, 2, 0
73, 66, 139, Dy, -37700, 500, 7971, 4, 0
90, 50, 140, Sn, -34490, 300, 8038, 2, 0
89, 51, 140, Sb, -44390, 600, 8103, 4, 0
88, 52, 140, Te, -56367.449, 14.377, 8183.3, 5670, 0
87, 53, 140, I, -63606.223, 12.109, 8229.4, 7400, 0
86, 54, 140, Xe, -72986.461, 2.329, 8290.8, 8750, 0
85, 55, 140, Cs, -77049.738, 8.199, 8314.3, 2270, 0
84, 56, 140, Ba, -83267.905, 7.900, 8353.1, 5000, 0
83, 57, 140, La, -84312.059, 0.607, 8355.0, 2010, 0
82, 58, 140, Ce, -88074.227, 1.313, 8376.3, 0450, 0
81, 59, 140, Pr, -84686.227, 6.142, 8346.5, 1630, 0
80, 60, 140, Nd, -84257.246, 3.260, 8337.8, 6400, 0
79, 61, 140, Pm, -78212.046, 24.220, 8289.0, 9580, 0
78, 62, 140, Sm, -75455.945, 12.497, 8263.8, 2110, 0
77, 63, 140, Eu, -66985.945, 51.538, 8197.7, 3300, 0
76, 64, 140, Gd, -61782.278, 27.945, 8154.9, 7570, 0
75, 65, 140, Tb, -50482.278, 800.488, 8068.6, 7325, 0
74, 66, 140, Dy, -42830, 401, 8008, 3, 0
73, 67, 140, Ho, -29317, 500, 7906, 4, 0
90, 51, 141, Sb, -39540, 500, 8069, 4, 0
89, 52, 141, Te, -50670, 400, 8142, 3, 0
88, 53, 141, I, -59926.666, 15.835, 8202.2, 5620, 0
87, 54, 141, Xe, -68197.309, 2.888, 8255.3, 6470, 0
86, 55, 141, Cs, -74477.351, 9.195, 8294.3, 5540, 0
85, 56, 141, Ba, -79732.492, 5.318, 8326.0, 7740, 0
84, 57, 141, La, -82929.844, 4.127, 8343.2, 0500, 0
83, 58, 141, Ce, -85431.058, 1.315, 8355.3, 9560, 0
82, 59, 141, Pr, -86014.533, 1.498, 8353.9, 8520, 0
81, 60, 141, Nd, -84191.520, 3.183, 8335.5, 0740, 0
80, 61, 141, Pm, -80522.932, 13.972, 8303.9, 4050, 0
79, 62, 141, Sm, -75933.959, 8.535, 8265.8, 4600, 0
78, 63, 141, Eu, -69925.647, 12.639, 8217.6, 8530, 0
77, 64, 141, Gd, -63224.231, 19.760, 8164.6, 0900, 0
76, 65, 141, Tb, -54540.843, 105.259, 8097.4, 7610, 0
75, 66, 141, Dy, -45382, 298, 8027, 2, 0
74, 67, 141, Ho, -34364, 401, 7943, 3, 0
91, 51, 142, Sb, -33610, 300, 8027, 2, 0
90, 52, 142, Te, -46550, 500, 8113, 4, 0
89, 53, 142, I, -54802.969, 4.937, 8165.2, 5170, 0
88, 54, 142, Xe, -65229.648, 2.701, 8233.1, 6950, 0
87, 55, 142, Cs, -70514.556, 7.067, 8264.8, 7770, 0
86, 56, 142, Ba, -77842.257, 5.920, 8310.9, 7180, 0
85, 57, 142, La, -80023.950, 6.286, 8320.8, 2630, 0
84, 58, 142, Ce, -84532.896, 2.443, 8347.0, 7000, 0
83, 59, 142, Pr, -83786.367, 1.498, 8336.3, 0320, 0
82, 60, 142, Nd, -85950.055, 1.256, 8346.0, 3100, 0
81, 61, 142, Pm, -81141.536, 23.596, 8306.6, 5870, 0
80, 62, 142, Sm, -78981.930, 1.866, 8285.9, 4070, 0
79, 63, 142, Eu, -71308.930, 30.058, 8226.3, 9600, 0
78, 64, 142, Gd, -66959.522, 27.945, 8190.2, 5690, 0
77, 65, 142, Tb, -56559.522, 700.558, 8111.5, 0804, 0
76, 66, 142, Dy, -50120, 729, 8061, 5, 0
75, 67, 142, Ho, -37250, 401, 7965, 3, 0
74, 68, 142, Er, -27930, 500, 7893, 4, 0
91, 52, 143, Te, -40530, 500, 8070, 3, 0
90, 53, 143, I, -50790, 200, 8137, 1, 0
89, 54, 143, Xe, -60202.882, 4.657, 8196.8, 8550, 0
88, 55, 143, Cs, -67675.519, 7.573, 8243.6, 7070, 0
87, 56, 143, Ba, -73937.205, 6.756, 8281.9, 8780, 0
86, 57, 143, La, -78171.467, 7.329, 8306.1, 2710, 0
85, 58, 143, Ce, -81606.378, 2.442, 8324.6, 7650, 0
84, 59, 143, Pr, -83068.200, 1.816, 8329.4, 2800, 0
83, 60, 143, Nd, -84002.310, 1.255, 8330.4, 8930, 0
82, 61, 143, Pm, -82960.664, 2.944, 8317.7, 3410, 0
81, 62, 143, Sm, -79517.135, 2.750, 8288.1, 8250, 0
80, 63, 143, Eu, -74241.311, 10.986, 8245.8, 1770, 0
79, 64, 143, Gd, -68231.311, 200.301, 8198.3, 1881, 0
78, 65, 143, Tb, -60419.192, 51.232, 8138.2, 1760, 0
77, 66, 143, Dy, -52168.949, 13.041, 8075.0, 5270, 0
76, 67, 143, Ho, -42048, 298, 7999, 2, 0
75, 68, 143, Er, -31160, 400, 7917, 3, 0
92, 52, 144, Te, -36220, 300, 8040, 2, 0
91, 53, 144, I, -45330, 400, 8098, 3, 0
90, 54, 144, Xe, -56872.301, 5.310, 8172.8, 8450, 0
89, 55, 144, Cs, -63271.362, 20.132, 8211.8, 8940, 0
88, 56, 144, Ba, -71767.130, 7.136, 8265.4, 5490, 0
87, 57, 144, La, -74849.660, 12.937, 8281.4, 2830, 0
86, 58, 144, Ce, -80431.942, 2.833, 8314.7, 6120, 0
85, 59, 144, Pr, -80750.588, 2.708, 8311.5, 4110, 0
84, 60, 144, Nd, -83748.028, 1.255, 8326.9, 2370, 0
83, 61, 144, Pm, -81416.116, 2.912, 8305.2, 9690, 0
82, 62, 144, Sm, -81965.626, 1.459, 8303.6, 8000, 0
81, 63, 144, Eu, -75619.175, 10.787, 8254.1, 7440, 0
80, 64, 144, Gd, -71759.511, 27.945, 8221.9, 3820, 0
79, 65, 144, Tb, -62368.188, 27.945, 8151.2, 8770, 0
78, 66, 144, Dy, -56570.091, 7.173, 8105.5, 9020, 0
77, 67, 144, Ho, -44609.521, 8.477, 8017.0, 9770, 0
76, 68, 144, Er, -36608, 196, 7956, 1, 0
75, 69, 144, Tm, -22159, 400, 7850, 3, 0
93, 52, 145, Te, -30010, 300, 7998, 2, 0
92, 53, 145, I, -41130, 500, 8069, 3, 0
91, 54, 145, Xe, -51493.337, 11.178, 8135.0, 8770, 0
90, 55, 145, Cs, -60054.424, 9.067, 8188.7, 3420, 0
89, 56, 145, Ba, -67516.183, 8.477, 8234.7, 9910, 0
88, 57, 145, La, -72835.325, 12.269, 8266.0, 8730, 0
87, 58, 145, Ce, -77067.059, 33.900, 8289.8, 7620, 0
86, 59, 145, Pr, -79625.990, 7.149, 8302.1, 2850, 0
85, 60, 145, Nd, -81432.004, 1.271, 8309.1, 8830, 0
84, 61, 145, Pm, -81267.506, 2.805, 8302.6, 5830, 0
83, 62, 145, Sm, -80651.407, 1.485, 8293.0, 1390, 0
82, 63, 145, Eu, -77991.524, 3.060, 8269.2, 7440, 0
81, 64, 145, Gd, -72926.626, 19.716, 8228.9, 4850, 0
80, 65, 145, Tb, -66399.693, 110.896, 8178.5, 3970, 0
79, 66, 145, Dy, -58242.607, 6.520, 8116.8, 8840, 0
78, 67, 145, Ho, -49120.113, 7.452, 8048.5, 7920, 0
77, 68, 145, Er, -39240, 200, 7975, 1, 0
76, 69, 145, Tm, -27583, 196, 7889, 1, 0
93, 53, 146, I, -35540, 300, 8031, 2, 0
92, 54, 146, Xe, -47954.950, 24.219, 8110.4, 1540, 0
91, 55, 146, Cs, -55310.380, 2.893, 8155.4, 3650, 0
90, 56, 146, Ba, -64866.269, 1.770, 8215.5, 2930, 0
89, 57, 146, La, -69221.174, 1.675, 8239.9, 9880, 0
88, 58, 146, Ce, -75625.868, 14.665, 8278.5, 0810, 0
87, 59, 146, Pr, -76673.486, 34.356, 8280.3, 2500, 0
86, 60, 146, Nd, -80925.916, 1.273, 8304.0, 9270, 0
85, 61, 146, Pm, -79454.360, 4.275, 8288.6, 5500, 0
84, 62, 146, Sm, -80996.360, 3.045, 8293.8, 5810, 0
83, 63, 146, Eu, -77117.603, 6.009, 8261.9, 3270, 0
82, 64, 146, Gd, -76085.823, 4.076, 8249.5, 0720, 0
81, 65, 146, Tb, -67763.644, 44.860, 8187.1, 4740, 0
80, 66, 146, Dy, -62554.928, 6.695, 8146.1, 1280, 0
79, 67, 146, Ho, -51238.227, 6.587, 8063.2, 4260, 0
78, 68, 146, Er, -44322.019, 6.705, 8010.5, 1270, 0
77, 69, 146, Tm, -31055, 200, 7914, 1, 0
94, 53, 147, I, -31200, 300, 8001, 2, 0
93, 54, 147, Xe, -42400, 200, 8072, 1, 0
92, 55, 147, Cs, -51920.073, 8.383, 8131.8, 0100, 0
91, 56, 147, Ba, -60264.036, 19.748, 8183.2, 4050, 0
90, 57, 147, La, -66678.397, 10.712, 8221.5, 5360, 0
89, 58, 147, Ce, -72013.902, 8.580, 8252.5, 2740, 0
88, 59, 147, Pr, -75444.093, 15.855, 8270.5, 4000, 0
87, 60, 147, Nd, -78146.794, 1.275, 8283.6, 0360, 0
86, 61, 147, Pm, -79041.984, 1.288, 8284.3, 7120, 0
85, 62, 147, Sm, -79266.048, 1.262, 8280.5, 7340, 0
84, 63, 147, Eu, -77544.611, 2.569, 8263.5, 4090, 0
83, 64, 147, Gd, -75356.928, 1.887, 8243.3, 3660, 0
82, 65, 147, Tb, -70742.674, 8.096, 8206.6, 2500, 0
81, 66, 147, Dy, -64196.047, 8.849, 8156.7, 6800, 0
80, 67, 147, Ho, -55757.101, 5.001, 8094.0, 3810, 0
79, 68, 147, Er, -46607.814, 38.191, 8026.4, 7600, 0
78, 69, 147, Tm, -35974.407, 6.839, 7948.8, 1780, 0
94, 54, 148, Xe, -38650, 300, 8047, 2, 0
93, 55, 148, Cs, -46910.950, 13.041, 8097.5, 4690, 0
92, 56, 148, Ba, -57544.911, 1.490, 8164.1, 1180, 0
91, 57, 148, La, -62708.742, 19.468, 8193.7, 1650, 0
90, 58, 148, Ce, -70398.424, 11.195, 8240.3, 8760, 0
89, 59, 148, Pr, -72535.452, 15.041, 8249.5, 4090, 0
88, 60, 148, Nd, -77408.066, 2.053, 8277.1, 7780, 0
87, 61, 148, Pm, -76865.877, 5.690, 8268.2, 2830, 0
86, 62, 148, Sm, -79336.067, 1.246, 8279.6, 3260, 0
85, 63, 148, Eu, -76297.482, 9.961, 8253.8, 1550, 0
84, 64, 148, Gd, -76269.419, 1.460, 8248.3, 3980, 0
83, 65, 148, Tb, -70536.947, 12.463, 8204.3, 2070, 0
82, 66, 148, Dy, -67859.397, 8.724, 8180.9, 4300, 0
81, 67, 148, Ho, -57991.166, 83.834, 8108.9, 7970, 0
80, 68, 148, Er, -51478.997, 10.246, 8059.6, 9240, 0
79, 69, 148, Tm, -38765.034, 10.246, 7968.5, 0110, 0
78, 70, 148, Yb, -30230, 400, 7906, 3, 0
95, 54, 149, Xe, -33000, 300, 8009, 2, 0
94, 55, 149, Cs, -43300, 400, 8073, 3, 0
93, 56, 149, Ba, -52830.620, 2.515, 8131.8, 4950, 0
92, 57, 149, La, -60219.921, 200.262, 8176.1, 9151, 0
91, 58, 149, Ce, -66669.921, 10.246, 8214.2, 2940, 0
90, 59, 149, Pr, -71039.373, 9.874, 8238.3, 0400, 0
89, 60, 149, Nd, -74375.535, 2.054, 8255.4, 4370, 0
88, 61, 149, Pm, -76064.404, 2.184, 8261.5, 2770, 0
87, 62, 149, Sm, -77135.898, 1.157, 8263.4, 6830, 0
86, 63, 149, Eu, -76441.317, 3.903, 8253.5, 5600, 0
85, 64, 149, Gd, -75127.173, 3.310, 8239.4, 8560, 0
84, 65, 149, Tb, -71488.639, 3.629, 8209.8, 1530, 0
83, 66, 149, Dy, -67693.990, 9.183, 8179.0, 9720, 0
82, 67, 149, Ho, -61645.854, 11.985, 8133.2, 5500, 0
81, 68, 149, Er, -53741.621, 27.945, 8074.9, 5580, 0
80, 69, 149, Tm, -43940, 200, 8004, 1, 0
79, 70, 149, Yb, -33330, 300, 7927, 2, 0
96, 54, 150, Xe, -28990, 300, 7983, 2, 0
95, 55, 150, Cs, -38170, 400, 8039, 3, 0
94, 56, 150, Ba, -49889.799, 5.682, 8111.8, 4050, 0
93, 57, 150, La, -56311.147, 2.515, 8149.4, 3390, 0
92, 58, 150, Ce, -64846.863, 11.697, 8201.1, 2300, 0
91, 59, 150, Pr, -68300.509, 9.015, 8218.9, 3160, 0
90, 60, 150, Nd, -73679.951, 1.129, 8249.5, 7890, 0
89, 61, 150, Pm, -73597.336, 20.031, 8243.8, 1250, 0
88, 62, 150, Sm, -77051.336, 1.112, 8261.6, 2350, 0
87, 63, 150, Eu, -74792.369, 6.231, 8241.3, 4810, 0
86, 64, 150, Gd, -75764.051, 6.055, 8242.6, 1030, 0
85, 65, 150, Tb, -71105.789, 7.371, 8206.3, 3960, 0
84, 66, 150, Dy, -69309.618, 4.319, 8189.1, 4950, 0
83, 67, 150, Ho, -61945.892, 14.168, 8134.8, 4230, 0
82, 68, 150, Er, -57831.323, 17.194, 8102.1, 9620, 0
81, 69, 150, Tm, -46491, 196, 8021, 1, 0
80, 70, 150, Yb, -38830, 300, 7965, 2, 0
79, 71, 150, Lu, -24771, 300, 7866, 2, 0
96, 55, 151, Cs, -34280, 500, 8013, 3, 0
95, 56, 151, Ba, -44940, 400, 8079, 3, 0
94, 57, 151, La, -53310.339, 435.473, 8129.0, 4362, 0
93, 58, 151, Ce, -61225.058, 17.698, 8176.2, 7790, 0
92, 59, 151, Pr, -66779.681, 11.650, 8207.8, 8240, 0
91, 60, 151, Nd, -70943.183, 1.133, 8230.2, 7410, 0
90, 61, 151, Pm, -73386.260, 4.611, 8241.2, 7230, 0
89, 62, 151, Sm, -74576.480, 1.110, 8243.9, 7350, 0
88, 63, 151, Eu, -74653.098, 1.166, 8239.2, 9980, 0
87, 64, 151, Gd, -74188.920, 2.993, 8231.0, 4460, 0
86, 65, 151, Tb, -71623.541, 4.094, 8208.8, 7430, 0
85, 66, 151, Dy, -68752.388, 3.247, 8184.6, 7890, 0
84, 67, 151, Ho, -63622.746, 8.298, 8145.5, 2670, 0
83, 68, 151, Er, -58266.290, 16.470, 8104.8, 7230, 0
82, 69, 151, Tm, -50771.613, 19.375, 8050.0, 5760, 0
81, 70, 151, Yb, -41542.352, 300.492, 7983.7, 5561, 0
80, 71, 151, Lu, -30300, 300, 7904, 2, 0
97, 55, 152, Cs, -29130, 500, 7980, 3, 0
96, 56, 152, Ba, -41610, 400, 8057, 3, 0
95, 57, 152, La, -49290, 300, 8102, 2, 0
94, 58, 152, Ce, -58980, 200, 8161, 1, 0
93, 59, 152, Pr, -63758.070, 18.537, 8187.1, 0490, 0
92, 60, 152, Nd, -70149.663, 24.476, 8224.0, 0780, 0
91, 61, 152, Pm, -71254.468, 25.904, 8226.1, 2930, 0
90, 62, 152, Sm, -74762.977, 1.016, 8244.0, 6450, 0
89, 63, 152, Eu, -72888.500, 1.166, 8226.5, 8540, 0
88, 64, 152, Gd, -74707.304, 1.007, 8233.4, 0420, 0
87, 65, 152, Tb, -70717.304, 40.013, 8202.0, 0720, 0
86, 66, 152, Dy, -70117.963, 4.593, 8192.9, 1710, 0
85, 67, 152, Ho, -63604.636, 12.528, 8144.9, 1930, 0
84, 68, 152, Er, -60500.218, 8.830, 8119.3, 4850, 0
83, 69, 152, Tm, -51720.279, 54.027, 8056.4, 3870, 0
82, 70, 152, Yb, -46270.386, 149.708, 8015.4, 3710, 0
81, 71, 152, Lu, -33422, 196, 7926, 1, 0
97, 56, 153, Ba, -36470, 400, 8023, 3, 0
96, 57, 153, La, -46060, 300, 8081, 2, 0
95, 58, 153, Ce, -54910, 200, 8134, 1, 0
94, 59, 153, Pr, -61568.490, 11.882, 8172.0, 3710, 0
93, 60, 153, Nd, -67330.380, 2.747, 8204.5, 8320, 0
92, 61, 153, Pm, -70648.003, 9.063, 8221.1, 5360, 0
91, 62, 153, Sm, -72560.059, 1.025, 8228.5, 3730, 0
90, 63, 153, Eu, -73367.466, 1.171, 8228.7, 0110, 0
89, 64, 153, Gd, -72882.944, 1.002, 8220.4, 2090, 0
88, 65, 153, Tb, -71313.610, 3.947, 8205.0, 5040, 0
87, 66, 153, Dy, -69143.197, 4.001, 8185.7, 5140, 0
86, 67, 153, Ho, -65012.074, 5.066, 8153.6, 3720, 0
85, 68, 153, Er, -60466.682, 9.285, 8118.8, 1540, 0
84, 69, 153, Tm, -53972.610, 11.979, 8071.2, 5710, 0
83, 70, 153, Yb, -47160, 200, 8022, 1, 0
82, 71, 153, Lu, -38375.462, 150.017, 7959.0, 8820, 0
81, 72, 153, Hf, -27300, 300, 7882, 2, 0
98, 56, 154, Ba, -32920, 500, 8001, 3, 0
97, 57, 154, La, -41530, 300, 8051, 2, 0
96, 58, 154, Ce, -52220, 200, 8116, 1, 0
95, 59, 154, Pr, -57859.602, 100.005, 8147.2, 9940, 0
94, 60, 154, Nd, -65579.602, 1.025, 8192.3, 4910, 0
93, 61, 154, Pm, -68266.602, 25.021, 8204.7, 1700, 0
92, 62, 154, Sm, -72455.564, 1.305, 8226.8, 3790, 0
91, 63, 154, Eu, -71738.367, 1.188, 8217.1, 0060, 0
90, 64, 154, Gd, -73706.358, 0.994, 8224.7, 9960, 0
89, 65, 154, Tb, -70156.707, 45.309, 8196.6, 6970, 0
88, 66, 154, Dy, -70394.015, 7.431, 8193.1, 3050, 0
87, 67, 154, Ho, -64639.378, 8.216, 8150.6, 8250, 0
86, 68, 154, Er, -62604.974, 4.961, 8132.3, 9190, 0
85, 69, 154, Tm, -54427.142, 14.412, 8074.2, 0900, 0
84, 70, 154, Yb, -49932.093, 17.281, 8039.9, 4020, 0
83, 71, 154, Lu, -39667, 201, 7968, 1, 0
82, 72, 154, Hf, -32730, 300, 7918, 2, 0
98, 57, 155, La, -37930, 400, 8028, 3, 0
97, 58, 155, Ce, -47780, 300, 8087, 2, 0
96, 59, 155, Pr, -55415.335, 17.198, 8131.0, 3980, 0
95, 60, 155, Nd, -62283.796, 9.154, 8170.3, 0500, 0
94, 61, 155, Pm, -66940.006, 4.719, 8195.2, 9770, 0
93, 62, 155, Sm, -70191.206, 1.332, 8211.2, 2580, 0
92, 63, 155, Eu, -71818.337, 1.252, 8216.6, 7600, 0
91, 64, 155, Gd, -72070.298, 0.983, 8213.2, 5410, 0
90, 65, 155, Tb, -71250.439, 9.830, 8202.9, 1730, 0
89, 66, 155, Dy, -69155.939, 9.645, 8184.3, 5700, 0
88, 67, 155, Ho, -66039.799, 17.470, 8159.2, 0550, 0
87, 68, 155, Er, -62209.172, 6.074, 8129.4, 4440, 0
86, 69, 155, Tm, -56625.921, 9.921, 8088.3, 7600, 0
85, 70, 155, Yb, -50502.614, 16.600, 8043.8, 2340, 0
84, 71, 155, Lu, -42545.056, 19.245, 7987.4, 3690, 0
83, 72, 155, Hf, -34310, 300, 7929, 2, 0
82, 73, 155, Ta, -23988, 300, 7858, 2, 0
99, 57, 156, La, -33050, 400, 7997, 3, 0
98, 58, 156, Ce, -44820, 300, 8068, 2, 0
97, 59, 156, Pr, -51449.307, 1.025, 8105.2, 3370, 0
96, 60, 156, Nd, -60202.130, 1.304, 8156.3, 2650, 0
95, 61, 156, Pm, -64166.847, 1.188, 8176.7, 2630, 0
94, 62, 156, Sm, -69360.735, 8.522, 8205.0, 0540, 0
93, 63, 156, Eu, -70082.844, 3.532, 8204.6, 1920, 0
92, 64, 156, Gd, -72535.333, 0.983, 8215.3, 2530, 0
91, 65, 156, Tb, -70091.010, 3.768, 8194.6, 4150, 0
90, 66, 156, Dy, -70529.386, 0.988, 8192.4, 3660, 0
89, 67, 156, Ho, -65538.403, 38.424, 8155.4, 2800, 0
88, 68, 156, Er, -64211.683, 24.629, 8141.9, 0840, 0
87, 69, 156, Tm, -56834.417, 14.279, 8089.6, 0320, 0
86, 70, 156, Yb, -53265.538, 9.308, 8061.7, 1070, 0
85, 71, 156, Lu, -43699.550, 54.122, 7995.3, 7520, 0
84, 72, 156, Hf, -37819.514, 149.740, 7952.6, 6760, 0
83, 73, 156, Ta, -26001, 300, 7872, 2, 0
100, 57, 157, La, -29070, 300, 7972, 2, 0
99, 58, 157, Ce, -39930, 400, 8037, 3, 0
98, 59, 157, Pr, -48434.806, 3.167, 8085.8, 1700, 0
97, 60, 157, Nd, -56494.117, 2.137, 8132.1, 6710, 0
96, 61, 157, Pm, -62297.116, 7.006, 8164.1, 4580, 0
95, 62, 157, Sm, -66677.654, 4.434, 8187.0, 6420, 0
94, 63, 157, Eu, -69459.134, 4.234, 8199.7, 9750, 0
93, 64, 157, Gd, -70823.896, 0.977, 8203.5, 0720, 0
92, 65, 157, Tb, -70763.848, 1.018, 8198.1, 4160, 0
91, 66, 157, Dy, -69424.669, 5.154, 8184.6, 2870, 0
90, 67, 157, Ho, -66832.862, 23.469, 8163.1, 3730, 0
89, 68, 157, Er, -63413.648, 26.505, 8136.3, 7570, 0
88, 69, 157, Tm, -58709.279, 27.945, 8101.4, 2850, 0
87, 70, 157, Yb, -53419.912, 10.905, 8062.7, 5510, 0
86, 71, 157, Lu, -46439.818, 12.074, 8013.3, 1280, 0
85, 72, 157, Hf, -38855, 200, 7960, 1, 0
84, 73, 157, Ta, -29595.948, 150.052, 7896.0, 6080, 0
83, 74, 157, W, -19690, 400, 7828, 3, 0
100, 58, 158, Ce, -36540, 400, 8015, 3, 0
99, 59, 158, Pr, -44150, 300, 8059, 2, 0
98, 60, 158, Nd, -53835.123, 1.304, 8114.9, 5290, 0
97, 61, 158, Pm, -59106.143, 0.888, 8143.3, 6220, 0
96, 62, 158, Sm, -65251.849, 4.782, 8177.3, 0750, 0
95, 63, 158, Eu, -67270.461, 2.032, 8185.1, 3200, 0
94, 64, 158, Gd, -70689.969, 0.976, 8201.8, 2290, 0
93, 65, 158, Tb, -69470.883, 1.268, 8189.1, 5560, 0
92, 66, 158, Dy, -70407.152, 2.337, 8190.1, 2980, 0
91, 67, 158, Ho, -66187.396, 27.106, 8158.4, 7090, 0
90, 68, 158, Er, -65303.815, 25.219, 8147.9, 2700, 0
89, 69, 158, Tm, -58703.200, 25.219, 8101.1, 9940, 0
88, 70, 158, Yb, -56009.620, 7.973, 8079.1, 9990, 0
87, 71, 158, Lu, -47212.200, 15.125, 8018.5, 6850, 0
86, 72, 158, Hf, -42102.399, 17.494, 7981.2, 7640, 0
85, 73, 158, Ta, -31118, 201, 7907, 1, 0
84, 74, 158, W, -23693, 300, 7855, 2, 0
101, 58, 159, Ce, -31340, 500, 7983, 3, 0
100, 59, 159, Pr, -40770, 400, 8037, 3, 0
99, 60, 159, Nd, -49724.007, 29.808, 8088.8, 2240, 0
98, 61, 159, Pm, -56554.351, 10.039, 8126.8, 6010, 0
97, 62, 159, Sm, -62207.849, 5.934, 8157.4, 9630, 0
96, 63, 159, Eu, -66043.386, 4.320, 8176.6, 9870, 0
95, 64, 159, Gd, -68561.857, 0.980, 8187.6, 1770, 0
94, 65, 159, Tb, -69532.582, 1.103, 8188.8, 0250, 0
93, 66, 159, Dy, -69167.220, 1.439, 8181.5, 8420, 0
92, 67, 159, Ho, -67329.620, 3.045, 8165.1, 0660, 0
91, 68, 159, Er, -64561.120, 3.643, 8142.7, 7420, 0
90, 69, 159, Tm, -60570.404, 27.945, 8112.7, 5490, 0
89, 70, 159, Yb, -55833.517, 17.582, 8078.0, 4280, 0
88, 71, 159, Lu, -49708.609, 37.663, 8034.6, 0090, 0
87, 72, 159, Hf, -42852.606, 16.813, 7986.5, 6100, 0
86, 73, 159, Ta, -34439.157, 19.689, 7928.7, 2580, 0
85, 74, 159, W, -25434, 300, 7867, 2, 0
84, 75, 159, Re, -14805, 305, 7795, 2, 0
101, 59, 160, Pr, -36200, 400, 8009, 2, 0
100, 60, 160, Nd, -46724.515, 46.575, 8069.9, 6620, 0
99, 61, 160, Pm, -52894.639, 2.049, 8103.6, 3980, 0
98, 62, 160, Sm, -60233.172, 1.956, 8144.6, 1590, 0
97, 63, 160, Eu, -63493.449, 0.904, 8160.1, 0300, 0
96, 64, 160, Gd, -67942.060, 1.123, 8183.0, 1710, 0
95, 65, 160, Tb, -67836.474, 1.110, 8177.4, 6760, 0
94, 66, 160, Dy, -69672.425, 0.700, 8184.0, 5260, 0
93, 67, 160, Ho, -66382.425, 15.016, 8158.6, 0040, 0
92, 68, 160, Er, -66064.176, 24.246, 8151.7, 2170, 0
91, 69, 160, Tm, -60301.037, 32.686, 8110.8, 1240, 0
90, 70, 160, Yb, -58163.227, 5.496, 8092.5, 6140, 0
89, 71, 160, Lu, -50269.942, 56.821, 8038.3, 3870, 0
88, 72, 160, Hf, -45938.747, 9.540, 8006.3, 7910, 0
87, 73, 160, Ta, -35823.700, 54.316, 7938.2, 7040, 0
86, 74, 160, W, -29329.073, 149.810, 7892.7, 8930, 0
85, 75, 160, Re, -16878, 300, 7810, 2, 0
102, 59, 161, Pr, -32490, 500, 7986, 3, 0
101, 60, 161, Nd, -42230, 400, 8042, 2, 0
100, 61, 161, Pm, -50086.589, 9.035, 8085.9, 9770, 0
99, 62, 161, Sm, -56672.043, 6.817, 8122.0, 4180, 0
98, 63, 161, Eu, -61791.601, 10.400, 8148.9, 8100, 0
97, 64, 161, Gd, -65506.142, 1.504, 8167.1, 9340, 0
96, 65, 161, Tb, -67461.778, 1.218, 8174.4, 8090, 0
95, 66, 161, Dy, -68055.494, 0.697, 8173.3, 0930, 0
94, 67, 161, Ho, -67196.294, 2.151, 8163.1, 1340, 0
93, 68, 161, Er, -65201.298, 8.774, 8145.8, 6280, 0
92, 69, 161, Tm, -61898.715, 27.945, 8120.4, 9060, 0
91, 70, 161, Yb, -57834.248, 15.101, 8090.3, 8610, 0
90, 71, 161, Lu, -52562.349, 27.945, 8052.7, 8210, 0
89, 72, 161, Hf, -46315.817, 23.450, 8009.1, 2450, 0
88, 73, 161, Ta, -38778.575, 24.381, 7957.4, 5000, 0
87, 74, 161, W, -30507, 200, 7901, 1, 0
86, 75, 161, Re, -20842.820, 149.905, 7836.3, 2920, 0
85, 76, 161, Os, -10196, 400, 7765, 2, 0
102, 60, 162, Nd, -39010, 400, 8022, 2, 0
101, 61, 162, Pm, -46040, 300, 8061, 2, 0
100, 62, 162, Sm, -54379.053, 3.523, 8107.5, 7450, 0
99, 63, 162, Eu, -58722.944, 1.314, 8129.5, 5930, 0
98, 64, 162, Gd, -64280.720, 3.963, 8159.0, 3730, 0
97, 65, 162, Tb, -65879.548, 2.049, 8164.0, 7730, 0
96, 66, 162, Dy, -68181.169, 0.695, 8173.4, 5550, 0
95, 67, 162, Ho, -66040.563, 3.102, 8155.4, 1260, 0
94, 68, 162, Er, -66334.210, 0.756, 8152.3, 9590, 0
93, 69, 162, Tm, -61477.482, 26.058, 8117.5, 8680, 0
92, 70, 162, Yb, -59821.163, 15.103, 8102.5, 3330, 0
91, 71, 162, Lu, -52831.759, 75.036, 8054.5, 5960, 0
90, 72, 162, Hf, -49168.426, 8.952, 8027.1, 1710, 0
89, 73, 162, Ta, -39781.405, 63.322, 7964.3, 4320, 0
88, 74, 162, W, -33999.217, 17.657, 7923.8, 2140, 0
87, 75, 162, Re, -22453, 201, 7848, 1, 0
86, 76, 162, Os, -14500, 300, 7794, 2, 0
103, 60, 163, Nd, -34080, 500, 7992, 3, 0
102, 61, 163, Pm, -42960, 400, 8042, 2, 0
101, 62, 163, Sm, -50599.612, 7.359, 8084.1, 6530, 0
100, 63, 163, Eu, -56573.819, 0.904, 8116.0, 1720, 0
99, 64, 163, Gd, -61388.591, 0.797, 8140.7, 5600, 0
98, 65, 163, Tb, -64595.754, 4.060, 8155.6, 3220, 0
97, 66, 163, Dy, -66380.858, 0.693, 8161.7, 8400, 0
96, 67, 163, Ho, -66378.027, 0.693, 8156.9, 6700, 0
95, 68, 163, Er, -65167.413, 4.628, 8144.7, 4030, 0
94, 69, 163, Tm, -62728.413, 5.515, 8124.9, 7740, 0
93, 70, 163, Yb, -59293.878, 15.105, 8099.1, 0690, 0
92, 71, 163, Lu, -54791.415, 27.945, 8066.6, 8480, 0
91, 72, 163, Hf, -49269.320, 25.693, 8028.0, 0720, 0
90, 73, 163, Ta, -42534.634, 38.061, 7981.8, 9050, 0
89, 74, 163, W, -34908.439, 58.426, 7930.3, 0430, 0
88, 75, 163, Re, -26002.253, 18.534, 7870.8, 6550, 0
87, 76, 163, Os, -16336, 300, 7807, 2, 0
86, 77, 163, Ir, -5310, 400, 7734, 2, 0
103, 61, 164, Pm, -38360, 400, 8014, 2, 0
102, 62, 164, Sm, -47925.314, 4.099, 8067.7, 8030, 0
101, 63, 164, Eu, -53232.146, 2.068, 8095.3, 6860, 0
100, 64, 164, Gd, -59693.688, 1.000, 8129.9, 9780, 0
99, 65, 164, Tb, -62104.983, 1.863, 8139.9, 3040, 0
98, 66, 164, Dy, -65967.649, 0.695, 8158.7, 1290, 0
97, 67, 164, Ho, -64980.517, 1.390, 8147.9, 2340, 0
96, 68, 164, Er, -65942.573, 0.704, 8149.0, 1910, 0
95, 69, 164, Tm, -61908.943, 25.006, 8119.6, 5340, 0
94, 70, 164, Yb, -61012.171, 15.106, 8109.4, 1490, 0
93, 71, 164, Lu, -54642.376, 27.945, 8065.8, 0430, 0
92, 72, 164, Hf, -51818.356, 15.812, 8043.8, 1420, 0
91, 73, 164, Ta, -43282.805, 27.945, 7986.9, 9780, 0
90, 74, 164, W, -38235.555, 9.673, 7951.4, 5150, 0
89, 75, 164, Re, -27472.441, 54.555, 7881.0, 5230, 0
88, 76, 164, Os, -20424.723, 149.903, 7833.3, 0800, 0
87, 77, 164, Ir, -7483, 316, 7750, 2, 0
104, 61, 165, Pm, -34670, 500, 7992, 3, 0
103, 62, 165, Sm, -43510, 400, 8041, 2, 0
102, 63, 165, Eu, -50729.103, 5.213, 8080.0, 5290, 0
101, 64, 165, Gd, -56525.782, 1.304, 8110.4, 4280, 0
100, 65, 165, Tb, -60588.849, 1.541, 8130.3, 2590, 0
99, 66, 165, Dy, -63612.289, 0.697, 8143.9, 0830, 0
98, 67, 165, Ho, -64898.017, 0.786, 8146.9, 5910, 0
97, 68, 165, Er, -64521.353, 0.918, 8139.9, 3480, 0
96, 69, 165, Tm, -62930.024, 1.658, 8125.5, 4890, 0
95, 70, 165, Yb, -60295.388, 26.539, 8104.8, 3990, 0
94, 71, 165, Lu, -56442.248, 26.539, 8076.7, 4600, 0
93, 72, 165, Hf, -51635.513, 27.945, 8042.8, 7280, 0
92, 73, 165, Ta, -45847.872, 13.573, 8003.0, 5470, 0
91, 74, 165, W, -38861.316, 25.756, 7955.9, 7040, 0
90, 75, 165, Re, -30659.353, 23.593, 7901.5, 2010, 0
89, 76, 165, Os, -21747, 200, 7843, 1, 0
88, 77, 165, Ir, -11595, 158, 7776, 1, 0
87, 78, 165, Pt, -318, 400, 7703, 2, 0
104, 62, 166, Sm, -40450, 400, 8023, 2, 0
103, 63, 166, Eu, -46749, 100, 8056, 1, 0
102, 64, 166, Gd, -54370.926, 1.584, 8097.2, 2600, 0
101, 65, 166, Tb, -57808.778, 1.463, 8113.2, 2300, 0
100, 66, 166, Dy, -62584.471, 0.804, 8137.2, 7930, 0
99, 67, 166, Ho, -63070.339, 0.786, 8135.4, 9330, 0
98, 68, 166, Er, -64924.145, 0.334, 8141.9, 4790, 0
97, 69, 166, Tm, -61886.478, 11.552, 8118.9, 3570, 0
96, 70, 166, Yb, -61593.706, 7.001, 8112.4, 5910, 0
95, 71, 166, Lu, -56020.987, 29.808, 8074.1, 7560, 0
94, 72, 166, Hf, -53858.989, 27.945, 8056.4, 3860, 0
93, 73, 166, Ta, -46097.780, 27.945, 8004.9, 7140, 0
92, 74, 166, W, -41887.471, 9.463, 7974.8, 9510, 0
91, 75, 166, Re, -31837.335, 88.242, 7909.6, 3920, 0
90, 76, 166, Os, -25431.526, 17.966, 7866.3, 3710, 0
89, 77, 166, Ir, -13306, 201, 7789, 1, 0
88, 78, 166, Pt, -4783, 300, 7733, 2, 0
105, 62, 167, Sm, -35330, 500, 7992, 3, 0
104, 63, 167, Eu, -43770, 400, 8038, 2, 0
103, 64, 167, Gd, -50775.732, 5.213, 8075.5, 4280, 0
102, 65, 167, Tb, -55883.082, 1.929, 8101.4, 4100, 0
101, 66, 167, Dy, -59911.451, 4.005, 8120.8, 7820, 0
100, 67, 167, Ho, -62279.459, 5.189, 8130.3, 7320, 0
99, 68, 167, Er, -63289.256, 0.286, 8131.7, 3520, 0
98, 69, 167, Tm, -62543.117, 1.258, 8122.5, 8260, 0
97, 70, 167, Yb, -60589.900, 3.960, 8106.2, 0200, 0
96, 71, 167, Lu, -57526.281, 37.260, 8083.1, 7220, 0
95, 72, 167, Hf, -53467.761, 27.945, 8054.1, 8500, 0
94, 73, 167, Ta, -48351.064, 27.945, 8018.8, 6140, 0
93, 74, 167, W, -42093.212, 18.703, 7976.7, 0450, 0
92, 75, 167, Re, -34834, 40, 7929, 0, 0
91, 76, 167, Os, -26498.860, 80.892, 7873.9, 5570, 0
90, 77, 167, Ir, -17072.448, 18.346, 7812.8, 2540, 0
89, 78, 167, Pt, -6753, 306, 7746, 2, 0
106, 62, 168, Sm, -31640, 300, 7971, 2, 0
105, 63, 168, Eu, -39250, 400, 8012, 2, 0
104, 64, 168, Gd, -48150, 300, 8060, 2, 0
103, 65, 168, Tb, -52781.181, 4.192, 8082.7, 9800, 0
102, 66, 168, Dy, -58558.398, 140.007, 8112.5, 2930, 0
101, 67, 168, Ho, -60059.231, 30.001, 8116.8, 0610, 0
100, 68, 168, Er, -62989.231, 0.262, 8129.5, 8970, 0
99, 69, 168, Tm, -61312.379, 1.677, 8114.9, 5160, 0
98, 70, 168, Yb, -61579.867, 0.093, 8111.8, 8700, 0
97, 71, 168, Lu, -57072.832, 37.973, 8080.4, 0260, 0
96, 72, 168, Hf, -55360.557, 27.945, 8065.5, 5360, 0
95, 73, 168, Ta, -48393.913, 27.945, 8019.4, 2870, 0
94, 74, 168, W, -44892.930, 13.259, 7993.9, 3270, 0
93, 75, 168, Re, -35794.889, 30.821, 7935.1, 2080, 0
92, 76, 168, Os, -29994.995, 9.903, 7895.9, 4080, 0
91, 77, 168, Ir, -18666.230, 55.216, 7823.8, 5090, 0
90, 78, 168, Pt, -11010.078, 149.934, 7773.6, 2170, 0
89, 79, 168, Au, 2530, 400, 7688, 2, 0
106, 63, 169, Eu, -35660, 500, 7991, 3, 0
105, 64, 169, Gd, -43890, 400, 8035, 2, 0
104, 65, 169, Tb, -50480, 300, 8069, 2, 0
103, 66, 169, Dy, -55596.010, 300.669, 8094.7, 5661, 0
102, 67, 169, Ho, -58796.010, 20.048, 8109.0, 6220, 0
101, 68, 169, Er, -60921.163, 0.304, 8117.0, 0780, 0
100, 69, 169, Tm, -61274.654, 0.738, 8114.4, 7020, 0
99, 70, 169, Yb, -60375.527, 0.178, 8104.5, 2060, 0
98, 71, 169, Lu, -58082.527, 3.005, 8086.3, 2330, 0
97, 72, 169, Hf, -54716.895, 27.945, 8061.7, 7910, 0
96, 73, 169, Ta, -50290.435, 27.945, 8030.9, 5770, 0
95, 74, 169, W, -44917.866, 15.436, 7994.5, 3810, 0
94, 75, 169, Re, -38409.247, 11.369, 7951.3, 9630, 0
93, 76, 169, Os, -30722.984, 25.940, 7901.2, 8620, 0
92, 77, 169, Ir, -22093.416, 23.307, 7845.5, 9440, 0
91, 78, 169, Pt, -12464, 200, 7784, 1, 0
90, 79, 169, Au, -1788, 298, 7716, 2, 0
107, 63, 170, Eu, -30860, 500, 7963, 3, 0
106, 64, 170, Gd, -40850, 500, 8017, 3, 0
105, 65, 170, Tb, -46710, 300, 8047, 2, 0
104, 66, 170, Dy, -53710, 200, 8084, 1, 0
103, 67, 170, Ho, -56237.514, 50.019, 8093.7, 9020, 0
102, 68, 170, Er, -60107.514, 1.387, 8111.9, 5290, 0
101, 69, 170, Tm, -59795.314, 0.732, 8105.5, 1440, 0
100, 70, 170, Yb, -60763.929, 0.010, 8106.6, 1010, 0
99, 71, 170, Lu, -57306.234, 16.843, 8081.6, 6860, 0
98, 72, 170, Hf, -56253.860, 27.945, 8070.8, 7620, 0
97, 73, 170, Ta, -50137.670, 27.945, 8030.2, 9650, 0
96, 74, 170, W, -47290.804, 13.195, 8008.9, 4820, 0
95, 75, 170, Re, -38903.996, 11.427, 7955.0, 1200, 0
94, 76, 170, Os, -33925.692, 9.759, 7921.1, 2580, 0
93, 77, 170, Ir, -23182, 101, 7853, 1, 0
92, 78, 170, Pt, -16299.202, 18.246, 7808.2, 3650, 0
91, 79, 170, Au, -3703, 201, 7730, 1, 0
90, 80, 170, Hg, 5415, 302, 7671, 2, 0
107, 64, 171, Gd, -36210, 500, 7990, 3, 0
106, 65, 171, Tb, -43770, 400, 8030, 2, 0
105, 66, 171, Dy, -50010, 200, 8062, 1, 0
104, 67, 171, Ho, -54517.822, 600.002, 8083.6, 0213, 0
103, 68, 171, Er, -57717.822, 1.408, 8097.7, 4040, 0
102, 69, 171, Tm, -59210.271, 0.972, 8101.8, 9310, 0
101, 70, 171, Yb, -59306.818, 0.013, 8097.8, 8260, 0
100, 71, 171, Lu, -57828.465, 1.862, 8084.6, 6210, 0
99, 72, 171, Hf, -55431.351, 28.876, 8066.0, 6870, 0
98, 73, 171, Ta, -51720.279, 27.945, 8039.7, 9140, 0
97, 74, 171, W, -47086.095, 27.945, 8008.1, 1580, 0
96, 75, 171, Re, -41250.285, 27.945, 7969.4, 1310, 0
95, 76, 171, Os, -34297.238, 18.247, 7924.1, 7690, 0
94, 77, 171, Ir, -26412.030, 38.466, 7873.4, 8950, 0
93, 78, 171, Pt, -17466.569, 80.951, 7816.6, 0170, 0
92, 79, 171, Au, -7562.303, 20.713, 7754.1, 0690, 0
91, 80, 171, Hg, 3339, 307, 7686, 2, 0
108, 64, 172, Gd, -32970, 300, 7972, 2, 0
107, 65, 172, Tb, -39690, 500, 8006, 3, 0
106, 66, 172, Dy, -47760, 300, 8049, 2, 0
105, 67, 172, Ho, -51484, 196, 8066, 1, 0
104, 68, 172, Er, -56482.578, 3.962, 8090.4, 0520, 0
103, 69, 172, Tm, -57373.554, 5.481, 8091.0, 3670, 0
102, 70, 172, Yb, -59255.456, 0.014, 8097.4, 2950, 0
101, 71, 172, Lu, -56736.076, 2.336, 8078.2, 3340, 0
100, 72, 172, Hf, -56402.232, 24.428, 8071.7, 4390, 0
99, 73, 172, Ta, -51329.983, 27.945, 8037.7, 0560, 0
98, 74, 172, W, -49097.191, 27.945, 8020.1, 7570, 0
97, 75, 172, Re, -41566.839, 35.568, 7971.8, 4600, 0
96, 76, 172, Os, -37243.641, 12.766, 7942.1, 6260, 0
95, 77, 172, Ir, -27379.373, 32.402, 7880.2, 6370, 0
94, 78, 172, Pt, -21106.670, 10.376, 7839.2, 4600, 0
93, 79, 172, Au, -9318.011, 56.158, 7766.1, 5870, 0
92, 80, 172, Hg, -1061.361, 150.062, 7713.6, 0640, 0
108, 65, 173, Tb, -36510, 500, 7988, 3, 0
107, 66, 173, Dy, -43740, 400, 8026, 2, 0
106, 67, 173, Ho, -49351, 298, 8054, 2, 0
105, 68, 173, Er, -53654, 196, 8074, 1, 0
104, 69, 173, Tm, -56256.067, 4.400, 8084.4, 6330, 0
103, 70, 173, Yb, -57551.234, 0.011, 8087.4, 2760, 0
102, 71, 173, Lu, -56881.014, 1.567, 8079.0, 3120, 0
101, 72, 173, Hf, -55411.790, 27.945, 8066.0, 1640, 0
100, 73, 173, Ta, -52396.543, 27.945, 8044.0, 6500, 0
99, 74, 173, W, -48727.388, 27.945, 8018.3, 3370, 0
98, 75, 173, Re, -43553.870, 27.945, 7983.9, 0680, 0
97, 76, 173, Os, -37438.250, 14.959, 7944.0, 3410, 0
96, 77, 173, Ir, -30268.456, 10.542, 7898.0, 6800, 0
95, 78, 173, Pt, -21936.758, 63.431, 7845.3, 8560, 0
94, 79, 173, Au, -12832.017, 22.783, 7788.2, 3480, 0
93, 80, 173, Hg, -2661, 201, 7725, 1, 0
109, 65, 174, Tb, -31970, 500, 7963, 3, 0
108, 66, 174, Dy, -41130, 500, 8011, 3, 0
107, 67, 174, Ho, -45870, 300, 8034, 2, 0
106, 68, 174, Er, -51949, 298, 8064, 2, 0
105, 69, 174, Tm, -53864.521, 44.721, 8070.6, 4320, 0
104, 70, 174, Yb, -56944.521, 0.011, 8083.8, 4810, 0
103, 71, 174, Lu, -55570.292, 1.567, 8071.4, 5400, 0
102, 72, 174, Hf, -55844.583, 2.259, 8068.5, 3410, 0
101, 73, 174, Ta, -51740.771, 27.945, 8040.4, 5280, 0
100, 74, 174, W, -50227.093, 27.945, 8027.2, 5720, 0
99, 75, 174, Re, -43673.101, 27.945, 7985.0, 9440, 0
98, 76, 174, Os, -39995.383, 10.254, 7959.4, 6180, 0
97, 77, 174, Ir, -30785.937, 11.221, 7902.0, 3770, 0
96, 78, 174, Pt, -25317.608, 10.338, 7866.1, 1430, 0
95, 79, 174, Au, -14058, 102, 7797, 1, 0
94, 80, 174, Hg, -6641.017, 19.211, 7749.7, 8510, 0
109, 66, 175, Dy, -36730, 500, 7986, 3, 0
108, 67, 175, Ho, -43300, 400, 8019, 2, 0
107, 68, 175, Er, -48652, 401, 8045, 2, 0
106, 69, 175, Tm, -52310.556, 50.000, 8061.7, 6730, 0
105, 70, 175, Yb, -54695.556, 0.071, 8070.9, 2530, 0
104, 71, 175, Lu, -55165.678, 1.207, 8069.1, 4120, 0
103, 72, 175, Hf, -54481.763, 2.283, 8060.7, 6250, 0
102, 73, 175, Ta, -52408.653, 27.945, 8044.4, 4560, 0
101, 74, 175, W, -49632.800, 27.945, 8024.1, 1300, 0
100, 75, 175, Re, -45288.312, 27.945, 7994.8, 1680, 0
99, 76, 175, Os, -40105.360, 11.775, 7960.7, 2940, 0
98, 77, 175, Ir, -33394.511, 12.384, 7917.9, 1120, 0
97, 78, 175, Pt, -25708.684, 18.614, 7869.5, 2160, 0
96, 79, 175, Au, -17403.686, 38.563, 7817.5, 9390, 0
95, 80, 175, Hg, -7969.443, 81.085, 7759.2, 1340, 0
110, 66, 176, Dy, -33610, 500, 7969, 3, 0
109, 67, 176, Ho, -39390, 500, 7997, 3, 0
108, 68, 176, Er, -46631, 401, 8034, 2, 0
107, 69, 176, Tm, -49371.322, 100.000, 8045.1, 2140, 0
106, 70, 176, Yb, -53491.322, 0.014, 8064.0, 8530, 0
105, 71, 176, Lu, -53382.333, 1.212, 8059.0, 2090, 0
104, 72, 176, Hf, -54576.428, 1.482, 8061.3, 6040, 0
103, 73, 176, Ta, -51365.379, 30.739, 8038.6, 7060, 0
102, 74, 176, W, -50641.608, 27.945, 8030.1, 1310, 0
101, 75, 176, Re, -45062.890, 27.945, 7993.9, 7070, 0
100, 76, 176, Os, -42131.184, 10.949, 7972.8, 6810, 0
99, 77, 176, Ir, -33881.923, 8.085, 7921.5, 5220, 0
98, 78, 176, Pt, -28933.918, 12.712, 7888.9, 9340, 0
97, 79, 176, Au, -18520.967, 33.185, 7825.3, 8370, 0
96, 80, 176, Hg, -11784.639, 11.118, 7782.6, 6400, 0
95, 81, 176, Tl, 584.728, 83.058, 7707.9, 3830, 0
110, 67, 177, Ho, -36280, 500, 7980, 3, 0
109, 68, 177, Er, -42858, 503, 8013, 3, 0
108, 69, 177, Tm, -47570, 200, 8035, 1, 0
107, 70, 177, Yb, -50986.404, 0.220, 8049.9, 7410, 0
106, 71, 177, Lu, -52383.903, 1.221, 8053.4, 4950, 0
105, 72, 177, Hf, -52880.745, 1.410, 8051.8, 3650, 0
104, 73, 177, Ta, -51714.745, 3.315, 8040.8, 2890, 0
103, 74, 177, W, -49701.731, 27.945, 8025.0, 3590, 0
102, 75, 177, Re, -46269.175, 27.945, 8001.2, 2290, 0
101, 76, 177, Os, -41956.448, 14.613, 7972.4, 3710, 0
100, 77, 177, Ir, -36047.425, 19.760, 7934.6, 3280, 0
99, 78, 177, Pt, -29370.437, 14.988, 7892.4, 8960, 0
98, 79, 177, Au, -21545.736, 9.968, 7843.8, 6230, 0
97, 80, 177, Hg, -12775.823, 84.722, 7789.8, 9470, 0
96, 81, 177, Tl, -3340.103, 21.628, 7732.1, 6550, 0
111, 67, 178, Ho, -32130, 500, 7957, 3, 0
110, 68, 178, Er, -40260, 596, 7999, 3, 0
109, 69, 178, Tm, -44240, 300, 8017, 2, 0
108, 70, 178, Yb, -49677.139, 6.588, 8042.7, 3860, 0
107, 71, 178, Lu, -50337.881, 2.251, 8042.0, 5540, 0
106, 72, 178, Hf, -52435.366, 1.415, 8049.4, 4380, 0
105, 73, 178, Ta, -50598, 52, 8035, 0, 0
104, 74, 178, W, -50407.066, 15.199, 8029.2, 5840, 0
103, 75, 178, Re, -45653.457, 27.945, 7998.1, 5760, 0
102, 76, 178, Os, -43544.243, 13.632, 7981.9, 1280, 0
101, 77, 178, Ir, -36254.314, 18.821, 7936.5, 6300, 0
100, 78, 178, Pt, -31997.486, 10.133, 7908.2, 5300, 0
99, 79, 178, Au, -22303.029, 10.246, 7849.3, 9460, 0
98, 80, 178, Hg, -16315.346, 10.758, 7811.3, 6070, 0
97, 81, 178, Tl, -4613, 102, 7741, 1, 0
96, 82, 178, Pb, 3573.371, 23.184, 7690.8, 3590, 0
111, 68, 179, Er, -36080, 500, 7976, 3, 0
110, 69, 179, Tm, -41900, 400, 8004, 2, 0
109, 70, 179, Yb, -46640, 200, 8026, 1, 0
108, 71, 179, Lu, -49059.013, 5.150, 8035.0, 7440, 0
107, 72, 179, Hf, -50463.036, 1.416, 8038.5, 4740, 0
106, 73, 179, Ta, -50357.456, 1.466, 8033.5, 8690, 0
105, 74, 179, W, -49295.247, 14.573, 8023.2, 8210, 0
104, 75, 179, Re, -46584.312, 24.639, 8003.7, 6660, 0
103, 76, 179, Os, -43020.137, 15.505, 7979.4, 8440, 0
102, 77, 179, Ir, -38081.719, 9.771, 7947.5, 2480, 0
101, 78, 179, Pt, -32268.127, 7.977, 7910.6, 7590, 0
100, 79, 179, Au, -24988.572, 11.696, 7865.6, 3740, 0
99, 80, 179, Hg, -16932.924, 28.121, 7816.2, 6310, 0
98, 81, 179, Tl, -8269.632, 38.653, 7763.4, 9420, 0
97, 82, 179, Pb, 2051.608, 81.229, 7701.4, 6300, 0
112, 68, 180, Er, -33180, 500, 7960, 3, 0
111, 69, 180, Tm, -38170, 400, 7983, 2, 0
110, 70, 180, Yb, -44720, 300, 8016, 2, 0
109, 71, 180, Lu, -46676.476, 70.725, 8022.0, 3940, 0
108, 72, 180, Hf, -49779.476, 1.421, 8034.9, 3190, 0
107, 73, 180, Ta, -48933.631, 2.068, 8025.8, 8640, 0
106, 74, 180, W, -49636.243, 1.439, 8025.4, 4340, 0
105, 75, 180, Re, -45837.364, 21.392, 7999.9, 9220, 0
104, 76, 180, Os, -44356.198, 15.722, 7987.4, 1710, 0
103, 77, 180, Ir, -37977.530, 21.706, 7947.6, 3370, 0
102, 78, 180, Pt, -34429.875, 10.051, 7923.5, 7810, 0
101, 79, 180, Au, -25625.646, 4.759, 7870.3, 1940, 0
100, 80, 180, Hg, -20250.513, 12.645, 7836.1, 1110, 0
99, 81, 180, Tl, -9390.438, 69.917, 7771.4, 3100, 0
98, 82, 180, Pb, -1941.069, 12.395, 7725.6, 9930, 0
112, 69, 181, Tm, -35440, 500, 7969, 3, 0
111, 70, 181, Yb, -41088, 298, 7996, 2, 0
110, 71, 181, Lu, -44797.414, 125.752, 8011.9, 3010, 0
109, 72, 181, Hf, -47402.958, 1.423, 8022.0, 0300, 0
108, 73, 181, Ta, -48439.064, 1.576, 8023.4, 0500, 0
107, 74, 181, W, -48233.945, 1.448, 8017.9, 4940, 0
106, 75, 181, Re, -46517.412, 12.549, 8004.1, 4340, 0
105, 76, 181, Os, -43549.968, 25.338, 7983.4, 2630, 0
104, 77, 181, Ir, -39463.035, 5.245, 7956.5, 2420, 0
103, 78, 181, Pt, -34381.497, 13.689, 7924.1, 2710, 0
102, 79, 181, Au, -27871.140, 19.976, 7883.8, 3590, 0
101, 80, 181, Hg, -20661.127, 15.382, 7839.6, 7920, 0
100, 81, 181, Tl, -12798.749, 9.102, 7791.9, 1830, 0
99, 82, 181, Pb, -3110.631, 85.037, 7734.0, 7040, 0
113, 69, 182, Tm, -31490, 500, 7948, 3, 0
112, 70, 182, Yb, -38900, 400, 7984, 2, 0
111, 71, 182, Lu, -41770, 200, 7996, 1, 0
110, 72, 182, Hf, -46049.636, 6.166, 8014.8, 3810, 0
109, 73, 182, Ta, -46430.685, 1.578, 8012.6, 3320, 0
108, 74, 182, W, -48246.144, 0.745, 8018.3, 0960, 0
107, 75, 182, Re, -45446.144, 101.983, 7998.6, 2640, 0
106, 76, 182, Os, -44609.109, 21.745, 7989.7, 2870, 0
105, 77, 182, Ir, -39051.682, 20.967, 7954.8, 9480, 0
104, 78, 182, Pt, -36168.420, 13.095, 7934.7, 5410, 0
103, 79, 182, Au, -28303.976, 18.764, 7887.2, 4420, 0
102, 80, 182, Hg, -23576.885, 9.790, 7856.9, 7260, 0
101, 81, 182, Tl, -13327.213, 11.976, 7796.3, 5710, 0
100, 82, 182, Pb, -6824.556, 12.086, 7756.3, 2960, 0
113, 70, 183, Yb, -35000, 400, 7963, 2, 0
112, 71, 183, Lu, -39716.114, 80.108, 7984.8, 1250, 0
111, 72, 183, Hf, -43283.547, 30.042, 8000.0, 3150, 0
110, 73, 183, Ta, -45293.547, 1.590, 8006.7, 4000, 0
109, 74, 183, W, -46365.663, 0.743, 8008.3, 2340, 0
108, 75, 183, Re, -45809.663, 8.034, 8001.0, 1010, 0
107, 76, 183, Os, -43663.760, 49.769, 7985.0, 0870, 0
106, 77, 183, Ir, -40202.138, 24.672, 7961.8, 1760, 0
105, 78, 183, Pt, -35773.197, 14.216, 7933.3, 4060, 0
104, 79, 183, Au, -30191.488, 9.423, 7898.5, 6440, 0
103, 80, 183, Hg, -23804.655, 7.084, 7859.3, 8850, 0
102, 81, 183, Tl, -16587.261, 9.331, 7815.6, 7410, 0
101, 82, 183, Pb, -7580.008, 28.979, 7762.1, 7900, 0
114, 70, 184, Yb, -32600, 503, 7951, 3, 0
113, 71, 184, Lu, -36300, 200, 7967, 1, 0
112, 72, 184, Hf, -41499.453, 39.706, 7990.7, 2280, 0
111, 73, 184, Ta, -42839.453, 26.010, 7993.7, 5350, 0
110, 74, 184, W, -45705.453, 0.738, 8005.0, 7770, 0
109, 75, 184, Re, -44219.819, 4.276, 7992.7, 5170, 0
108, 76, 184, Os, -44252.565, 0.829, 7988.6, 7780, 0
107, 77, 184, Ir, -39610.855, 27.945, 7959.1, 9920, 0
106, 78, 184, Pt, -37332.486, 14.744, 7942.5, 6490, 0
105, 79, 184, Au, -30318.714, 22.275, 7900.1, 9470, 0
104, 80, 184, Hg, -26344.787, 9.535, 7874.3, 4540, 0
103, 81, 184, Tl, -16883.355, 10.012, 7818.6, 7270, 0
102, 82, 184, Pb, -11051.586, 12.802, 7782.7, 2640, 0
101, 83, 184, Bi, 1254, 122, 7712, 1, 0
115, 70, 185, Yb, -28480, 500, 7929, 3, 0
114, 71, 185, Lu, -33960, 300, 7955, 2, 0
113, 72, 185, Hf, -38319.804, 64.273, 7973.9, 7110, 0
112, 73, 185, Ta, -41394.371, 14.161, 7986.3, 6150, 0
111, 74, 185, W, -43387.871, 0.739, 7992.9, 0830, 0
110, 75, 185, Re, -43819.047, 0.820, 7991.0, 1010, 0
109, 76, 185, Os, -42805.908, 0.832, 7981.3, 0470, 0
108, 77, 185, Ir, -40335.558, 27.945, 7963.7, 2260, 0
107, 78, 185, Pt, -36688.144, 25.832, 7939.7, 7790, 0
106, 79, 185, Au, -31858.150, 2.608, 7909.4, 4100, 0
105, 80, 185, Hg, -26183.651, 13.639, 7874.5, 3910, 0
104, 81, 185, Tl, -19757.745, 20.674, 7835.5, 7560, 0
103, 82, 185, Pb, -11541.211, 16.175, 7786.9, 3300, 0
102, 83, 185, Bi, -2236, 81, 7732, 0, 0
115, 71, 186, Lu, -30320, 400, 7936, 2, 0
114, 72, 186, Hf, -36424.214, 51.232, 7964.3, 0320, 0
113, 73, 186, Ta, -38607.602, 60.012, 7971.8, 3570, 0
112, 74, 186, W, -42508.602, 1.213, 7988.6, 0260, 0
111, 75, 186, Re, -41927.320, 0.820, 7981.2, 7130, 0
110, 76, 186, Os, -43000.032, 0.761, 7982.8, 3240, 0
109, 77, 186, Ir, -39172.350, 16.526, 7958.0, 4730, 0
108, 78, 186, Pt, -37864.447, 21.745, 7946.8, 0940, 0
107, 79, 186, Au, -31714.856, 20.967, 7909.5, 4090, 0
106, 80, 186, Hg, -28539.059, 11.650, 7888.2, 6050, 0
105, 81, 186, Tl, -19882.940, 20.751, 7837.5, 1610, 0
104, 82, 186, Pb, -14680.897, 11.004, 7805.3, 4200, 0
103, 83, 186, Bi, -3145.497, 16.954, 7739.1, 1750, 0
102, 84, 186, Po, 4101.531, 18.278, 7695.9, 4880, 0
116, 71, 187, Lu, -27770, 400, 7923, 2, 0
115, 72, 187, Hf, -33000, 200, 7947, 1, 0
114, 73, 187, Ta, -36895.550, 55.890, 7963.2, 1230, 0
113, 74, 187, W, -39904.044, 1.213, 7975.1, 1680, 0
112, 75, 187, Re, -41216.548, 0.737, 7977.9, 5190, 0
111, 76, 187, Os, -41219.015, 0.737, 7973.7, 8140, 0
110, 77, 187, Ir, -39549.377, 27.945, 7960.6, 6920, 0
109, 78, 187, Pt, -36685.361, 24.067, 7941.1, 6990, 0
108, 79, 187, Au, -33028.780, 22.499, 7917.4, 3230, 0
107, 80, 187, Hg, -28118.509, 12.864, 7886.9, 9050, 0
106, 81, 187, Tl, -22444.592, 8.048, 7852.4, 6500, 0
105, 82, 187, Pb, -14986.955, 5.094, 7808.4, 0100, 0
104, 83, 187, Bi, -6383.275, 10.005, 7758.2, 0830, 0
103, 84, 187, Po, 2823.808, 32.631, 7704.7, 8890, 0
117, 71, 188, Lu, -23820, 400, 7903, 2, 0
116, 72, 188, Hf, -30830, 300, 7936, 2, 0
115, 73, 188, Ta, -33910, 200, 7948, 1, 0
114, 74, 188, W, -38667.880, 3.089, 7969.0, 5320, 0
113, 75, 188, Re, -39016.880, 0.738, 7966.7, 4810, 0
112, 76, 188, Os, -41137.301, 0.734, 7973.8, 6560, 0
111, 77, 188, Ir, -38344.955, 9.423, 7954.8, 5120, 0
110, 78, 188, Pt, -37820.970, 5.305, 7947.9, 0270, 0
109, 79, 188, Au, -32371.315, 2.701, 7914.7, 5370, 0
108, 80, 188, Hg, -30198.351, 6.787, 7899.0, 3400, 0
107, 81, 188, Tl, -22336.403, 29.904, 7853.0, 5370, 0
106, 82, 188, Pb, -17811.024, 10.124, 7824.8, 2110, 0
105, 83, 188, Bi, -7194.800, 11.179, 7764.1, 9040, 0
104, 84, 188, Po, -544.378, 19.970, 7724.6, 5440, 0
117, 72, 189, Hf, -27150, 300, 7917, 2, 0
116, 73, 189, Ta, -31960, 200, 7938, 1, 0
115, 74, 189, W, -35809, 200, 7954, 1, 0
114, 75, 189, Re, -37979.097, 8.191, 7961.8, 1050, 0
113, 76, 189, Os, -38986.802, 0.666, 7963.0, 0290, 0
112, 77, 189, Ir, -38449.652, 12.576, 7956.0, 2140, 0
111, 78, 189, Pt, -36469.405, 10.090, 7941.4, 0450, 0
110, 79, 189, Au, -33581.958, 20.081, 7921.9, 8760, 0
109, 80, 189, Hg, -29626.378, 31.553, 7896.9, 1920, 0
108, 81, 189, Tl, -24616.105, 8.368, 7866.2, 7040, 0
107, 82, 189, Pb, -17844.019, 14.062, 7826.2, 9990, 0
106, 83, 189, Bi, -10064.664, 20.851, 7780.9, 9990, 0
105, 84, 189, Po, -1421.996, 22.059, 7731.1, 3210, 0
118, 72, 190, Hf, -24800, 400, 7905, 2, 0
117, 73, 190, Ta, -28720, 200, 7922, 1, 0
116, 74, 190, W, -34368.832, 35.391, 7947.5, 0310, 0
115, 75, 190, Re, -35583.015, 4.870, 7949.7, 7590, 0
114, 76, 190, Os, -38707.825, 0.650, 7962.1, 0470, 0
113, 77, 190, Ir, -36753.614, 1.370, 7947.7, 0170, 0
112, 78, 190, Pt, -37306.504, 0.657, 7946.4, 9410, 0
111, 79, 190, Au, -32833.540, 3.447, 7918.8, 3450, 0
110, 80, 190, Hg, -31370.625, 15.907, 7907.0, 1740, 0
109, 81, 190, Tl, -24366.236, 7.252, 7866.0, 3450, 0
108, 82, 190, Pb, -20416.607, 12.514, 7841.1, 2940, 0
107, 83, 190, Bi, -10595.906, 20.973, 7785.3, 2390, 0
106, 84, 190, Po, -4562.708, 13.163, 7749.4, 5260, 0
118, 73, 191, Ta, -26520, 300, 7911, 2, 0
117, 74, 191, W, -31176.176, 41.917, 7931.4, 3590, 0
116, 75, 191, Re, -34350.408, 10.264, 7943.9, 5880, 0
115, 76, 191, Os, -36395.239, 0.659, 7950.5, 6870, 0
114, 77, 191, Ir, -36708.826, 1.310, 7948.1, 1440, 0
113, 78, 191, Pt, -35698.336, 4.127, 7938.7, 2790, 0
112, 79, 191, Au, -33797.910, 4.926, 7924.6, 8190, 0
111, 80, 191, Hg, -30591.849, 22.280, 7903.8, 0020, 0
110, 81, 191, Tl, -26282.951, 7.349, 7877.1, 4450, 0
109, 82, 191, Pb, -20291.243, 6.613, 7841.6, 7820, 0
108, 83, 191, Bi, -13239.351, 7.487, 7800.6, 6130, 0
107, 84, 191, Po, -5068.731, 7.103, 7753.7, 8710, 0
106, 85, 191, At, 3863.913, 16.103, 7702.9, 2330, 0
119, 73, 192, Ta, -23100, 400, 7894, 2, 0
118, 74, 192, W, -29620, 200, 7924, 1, 0
117, 75, 192, Re, -31588.828, 70.794, 7930.2, 3890, 0
116, 76, 192, Os, -35882.303, 2.314, 7948.5, 2600, 0
115, 77, 192, Ir, -34835.631, 1.314, 7938.9, 9990, 0
114, 78, 192, Pt, -36288.525, 2.570, 7942.4, 9230, 0
113, 79, 192, Au, -32772.184, 15.827, 7920.1, 0330, 0
112, 80, 192, Hg, -32011.481, 15.537, 7912.0, 6660, 0
111, 81, 192, Tl, -25872.249, 31.671, 7876.0, 1670, 0
110, 82, 192, Pb, -22551.846, 5.726, 7854.6, 4820, 0
109, 83, 192, Bi, -13534.537, 30.112, 7803.6, 0840, 0
108, 84, 192, Po, -8066.483, 10.634, 7771.0, 5420, 0
107, 85, 192, At, 2925.742, 27.873, 7709.7, 2830, 0
120, 73, 193, Ta, -20810, 400, 7883, 2, 0
119, 74, 193, W, -26190, 200, 7907, 1, 0
118, 75, 193, Re, -30231.641, 39.123, 7923.9, 3780, 0
117, 76, 193, Os, -33394.401, 2.320, 7936.2, 7160, 0
116, 77, 193, Ir, -34536.305, 1.327, 7938.1, 3460, 0
115, 78, 193, Pt, -34479.677, 1.359, 7933.7, 8750, 0
114, 79, 193, Au, -33404.829, 8.674, 7924.1, 6480, 0
113, 80, 193, Hg, -31062.165, 15.505, 7907.9, 7300, 0
112, 81, 193, Tl, -27477.218, 6.707, 7885.3, 4450, 0
111, 82, 193, Pb, -22229.255, 10.288, 7854.0, 9940, 0
110, 83, 193, Bi, -15884.563, 7.576, 7817.1, 7180, 0
109, 84, 193, Po, -8325.302, 14.531, 7773.9, 5100, 0
108, 85, 193, At, -67.323, 21.632, 7727.1, 0990, 0
107, 86, 193, Rn, 9042.920, 25.112, 7675.8, 5300, 0
121, 73, 194, Ta, -17130, 500, 7865, 3, 0
120, 74, 194, W, -24410, 300, 7899, 2, 0
119, 75, 194, Re, -27260, 200, 7909, 1, 0
118, 76, 194, Os, -32435.176, 2.403, 7932.0, 2320, 0
117, 77, 194, Ir, -32531.776, 1.332, 7928.4, 8850, 0
116, 78, 194, Pt, -34760.101, 0.496, 7935.9, 4200, 0
115, 79, 194, Au, -32211.950, 2.118, 7918.7, 7440, 0
114, 80, 194, Hg, -32183.952, 2.888, 7914.5, 9740, 0
113, 81, 194, Tl, -26937.498, 13.972, 7883.5, 2110, 0
112, 82, 194, Pb, -24207.866, 17.435, 7865.4, 1810, 0
111, 83, 194, Bi, -16023.020, 5.252, 7819.1, 9550, 0
110, 84, 194, Po, -11004.617, 12.911, 7789.2, 9470, 0
109, 85, 194, At, -716.490, 23.502, 7732.2, 3040, 0
108, 86, 194, Rn, 5724.624, 16.659, 7694.9, 9610, 0
121, 74, 195, W, -20740, 300, 7881, 2, 0
120, 75, 195, Re, -25560, 300, 7901, 2, 0
119, 76, 195, Os, -29511.596, 55.890, 7917.7, 4490, 0
118, 77, 195, Ir, -31692.318, 1.333, 7924.9, 1600, 0
117, 78, 195, Pt, -32793.878, 0.503, 7926.5, 5300, 0
116, 79, 195, Au, -32567.061, 1.119, 7921.3, 7780, 0
115, 80, 195, Hg, -31013.342, 23.142, 7909.3, 9800, 0
114, 81, 195, Tl, -28155.292, 11.126, 7890.7, 2930, 0
113, 82, 195, Pb, -23738.039, 5.088, 7864.0, 6470, 0
112, 83, 195, Bi, -18025.567, 5.287, 7830.7, 5790, 0
111, 84, 195, Po, -11116.655, 6.042, 7791.3, 1550, 0
110, 85, 195, At, -3470.299, 9.573, 7748.0, 9140, 0
109, 86, 195, Rn, 5050.285, 51.686, 7700.3, 8410, 0
122, 74, 196, W, -18740, 400, 7872, 2, 0
121, 75, 196, Re, -22360, 300, 7886, 2, 0
120, 76, 196, Os, -28277.123, 40.055, 7912.2, 3010, 0
119, 77, 196, Ir, -29435.522, 38.414, 7914.1, 4870, 0
118, 78, 196, Pt, -32644.538, 0.510, 7926.5, 2970, 0
117, 79, 196, Au, -31138.718, 2.962, 7914.8, 5530, 0
116, 80, 196, Hg, -31825.944, 2.946, 7914.3, 7000, 0
115, 81, 196, Tl, -27496.598, 12.109, 7888.2, 9000, 0
114, 82, 196, Pb, -25348.234, 7.710, 7873.3, 3740, 0
113, 83, 196, Bi, -18009.032, 24.428, 7831.9, 0090, 0
112, 84, 196, Po, -13468.731, 5.383, 7804.7, 4450, 0
111, 85, 196, At, -3913.175, 30.235, 7752.0, 0010, 0
110, 86, 196, Rn, 1975.169, 14.054, 7717.9, 6600, 0
123, 74, 197, W, -14870, 400, 7853, 2, 0
122, 75, 197, Re, -20350, 300, 7877, 2, 0
121, 76, 197, Os, -25080, 200, 7897, 1, 0
120, 77, 197, Ir, -28264.123, 20.110, 7909.0, 0030, 0
119, 78, 197, Pt, -30419.775, 0.536, 7915.9, 7140, 0
118, 79, 197, Au, -31139.751, 0.542, 7915.6, 5480, 0
117, 80, 197, Hg, -30540.231, 3.207, 7908.6, 4020, 0
116, 81, 197, Tl, -28354.222, 13.575, 7893.5, 7250, 0
115, 82, 197, Pb, -24745.385, 4.804, 7871.2, 8220, 0
114, 83, 197, Bi, -19687.196, 8.333, 7841.6, 3480, 0
113, 84, 197, Po, -13393.078, 9.861, 7805.7, 1360, 0
112, 85, 197, At, -6355.255, 7.983, 7766.0, 1740, 0
111, 86, 197, Rn, 1510.368, 16.193, 7722.1, 1900, 0
110, 87, 197, Fr, 10253.968, 56.434, 7673.7, 6400, 0
123, 75, 198, Re, -16990, 400, 7861, 2, 0
122, 76, 198, Os, -23600, 200, 7890, 1, 0
121, 77, 198, Ir, -25710, 200, 7897, 1, 0
120, 78, 198, Pt, -29904.018, 2.100, 7914.1, 5120, 0
119, 79, 198, Au, -29580.793, 0.540, 7908.5, 6750, 0
118, 80, 198, Hg, -30954.315, 0.458, 7911.5, 5320, 0
117, 81, 198, Tl, -27528.753, 7.545, 7890.3, 0110, 0
116, 82, 198, Pb, -26067.443, 8.750, 7878.9, 6950, 0
115, 83, 198, Bi, -19373.851, 27.571, 7841.2, 1230, 0
114, 84, 198, Po, -15473.278, 17.424, 7817.5, 6110, 0
113, 85, 198, At, -6708.747, 4.904, 7769.3, 4460, 0
112, 86, 198, Rn, -1230.320, 13.420, 7737.7, 2450, 0
111, 87, 198, Fr, 9577.698, 31.130, 7679.1, 8730, 0
124, 75, 199, Re, -14730, 400, 7850, 2, 0
123, 76, 199, Os, -20270, 200, 7874, 1, 0
122, 77, 199, Ir, -24398.534, 41.054, 7891.2, 0660, 0
121, 78, 199, Pt, -27388.700, 2.159, 7902.3, 0110, 0
120, 79, 199, Au, -29093.752, 0.542, 7906.9, 3790, 0
119, 80, 199, Hg, -29546.066, 0.526, 7905.2, 7940, 0
118, 81, 199, Tl, -28059.397, 27.945, 7893.8, 7730, 0
117, 82, 199, Pb, -25231.734, 6.821, 7875.7, 3660, 0
116, 83, 199, Bi, -20797.616, 10.615, 7849.5, 2320, 0
115, 84, 199, Po, -15238.829, 5.429, 7817.6, 5820, 0
114, 85, 199, At, -8823.377, 5.384, 7781.4, 8830, 0
113, 86, 199, Rn, -1559.846, 7.297, 7741.0, 5680, 0
112, 87, 199, Fr, 6771.388, 13.726, 7695.2, 5990, 0
124, 76, 200, Os, -18550, 300, 7867, 1, 0
123, 77, 200, Ir, -21570, 196, 7878, 1, 0
122, 78, 200, Pt, -26599.178, 20.110, 7899.1, 9860, 0
121, 79, 200, Au, -27240.094, 26.717, 7898.4, 9150, 0
120, 80, 200, Hg, -29503.267, 0.530, 7905.8, 9560, 0
119, 81, 200, Tl, -27047.227, 5.759, 7889.7, 0370, 0
118, 82, 200, Pb, -26250.858, 10.008, 7881.8, 1010, 0
117, 83, 200, Bi, -20370.574, 22.701, 7848.4, 9690, 0
116, 84, 200, Po, -16941.683, 7.579, 7827.4, 4070, 0
115, 85, 200, At, -8987.894, 24.465, 7783.7, 6010, 0
114, 86, 200, Rn, -4000.454, 5.792, 7754.9, 1110, 0
113, 87, 200, Fr, 6133.578, 30.524, 7700.3, 2920, 0
125, 76, 201, Os, -14840, 300, 7849, 1, 0
124, 77, 201, Ir, -19840, 200, 7870, 1, 0
123, 78, 201, Pt, -23740.705, 50.103, 7885.8, 3370, 0
122, 79, 201, Au, -26400.705, 3.218, 7895.1, 7520, 0
121, 80, 201, Hg, -27662.529, 0.712, 7897.5, 6070, 0
120, 81, 201, Tl, -27180.778, 14.185, 7891.2, 7170, 0
119, 82, 201, Pb, -25271.033, 13.747, 7877.8, 7820, 0
118, 83, 201, Bi, -21429.006, 12.177, 7854.8, 7130, 0
117, 84, 201, Po, -16521.166, 4.942, 7826.5, 6190, 0
116, 85, 201, At, -10789.441, 8.184, 7794.1, 5360, 0
115, 86, 201, Rn, -4107.413, 10.121, 7757.0, 1740, 0
114, 87, 201, Fr, 3588.573, 9.080, 7714.8, 3670, 0
113, 88, 201, Ra, 11936.817, 20.301, 7669.4, 1080, 0
126, 76, 202, Os, -12530, 400, 7839, 2, 0
125, 77, 202, Ir, -16640, 300, 7855, 1, 0
124, 78, 202, Pt, -22692.128, 25.150, 7881.5, 6090, 0
123, 79, 202, Au, -24352.982, 23.287, 7885.9, 1000, 0
122, 80, 202, Hg, -27345.310, 0.705, 7896.8, 5050, 0
121, 81, 202, Tl, -25980.419, 1.838, 7886.2, 2060, 0
120, 82, 202, Pb, -25940.608, 3.796, 7882.1, 5050, 0
119, 83, 202, Bi, -20750.854, 14.002, 7852.5, 8570, 0
118, 84, 202, Po, -17941.569, 8.670, 7834.8, 0530, 0
117, 85, 202, At, -10595.106, 27.601, 7794.5, 6370, 0
116, 86, 202, Rn, -6274.561, 17.520, 7769.3, 0180, 0
115, 87, 202, Fr, 3101.538, 6.033, 7719.0, 1250, 0
114, 88, 202, Ra, 9074.900, 15.018, 7685.5, 6840, 0
127, 76, 203, Os, -7270, 400, 7814, 2, 0
126, 77, 203, Ir, -14370, 400, 7845, 2, 0
125, 78, 203, Pt, -19510, 200, 7867, 1, 0
124, 79, 203, Au, -23143.444, 3.083, 7880.8, 6500, 0
123, 80, 203, Hg, -25269.203, 1.630, 7887.4, 8280, 0
122, 81, 203, Tl, -25761.309, 1.171, 7886.0, 5300, 0
121, 82, 203, Pb, -24786.483, 6.554, 7877.3, 9700, 0
120, 83, 203, Bi, -21524.893, 12.778, 7857.4, 7620, 0
119, 84, 203, Po, -17310.819, 4.640, 7832.8, 6320, 0
118, 85, 203, At, -12162.607, 10.623, 7803.6, 4870, 0
117, 86, 203, Rn, -6184.045, 5.815, 7770.3, 4370, 0
116, 87, 203, Fr, 876.412, 6.232, 7731.7, 0920, 0
115, 88, 203, Ra, 8601.331, 9.688, 7689.8, 0150, 0
127, 77, 204, Ir, -9570, 400, 7823, 2, 0
126, 78, 204, Pt, -17620, 200, 7859, 1, 0
125, 79, 204, Au, -20390, 200, 7868, 1, 0
124, 80, 204, Hg, -24690.148, 0.498, 7885.5, 4550, 0
123, 81, 204, Tl, -24346.070, 1.154, 7880.0, 2380, 0
122, 82, 204, Pb, -25109.815, 1.147, 7879.9, 3260, 0
121, 83, 204, Bi, -20645.927, 9.180, 7854.2, 1570, 0
120, 84, 204, Po, -18341.045, 10.071, 7839.0, 8230, 0
119, 85, 204, At, -11875.252, 22.668, 7803.5, 5220, 0
118, 86, 204, Rn, -7970.115, 7.444, 7780.5, 7430, 0
117, 87, 204, Fr, 607.308, 24.581, 7734.6, 9310, 0
116, 88, 204, Ra, 6061.097, 8.924, 7704.1, 2380, 0
128, 77, 205, Ir, -5600, 500, 7805, 2, 0
127, 78, 205, Pt, -12820, 300, 7836, 1, 0
126, 79, 205, Au, -18570, 200, 7860, 1, 0
125, 80, 205, Hg, -22287.719, 3.655, 7874.7, 3250, 0
124, 81, 205, Tl, -23820.802, 1.239, 7878.3, 9460, 0
123, 82, 205, Pb, -23770.162, 1.145, 7874.3, 3130, 0
122, 83, 205, Bi, -21065.569, 4.808, 7857.3, 2180, 0
121, 84, 205, Po, -17521.398, 10.059, 7836.2, 1680, 0
120, 85, 205, At, -12984.519, 12.055, 7810.2, 6940, 0
119, 86, 205, Rn, -7709.764, 5.080, 7780.7, 2260, 0
118, 87, 205, Fr, -1309.816, 7.824, 7745.6, 8700, 0
117, 88, 205, Ra, 5803.853, 22.772, 7707.1, 6980, 0
116, 89, 205, Ac, 14106.689, 59.320, 7662.8, 5190, 0
128, 78, 206, Pt, -9240, 300, 7820, 1, 0
127, 79, 206, Au, -14190, 300, 7840, 1, 0
126, 80, 206, Hg, -20945.728, 20.441, 7869.1, 7230, 0
125, 81, 206, Tl, -22253.293, 1.286, 7871.7, 2190, 0
124, 82, 206, Pb, -23785.506, 1.144, 7875.3, 6200, 0
123, 83, 206, Bi, -20028.201, 7.632, 7853.3, 2490, 0
122, 84, 206, Po, -18188.668, 4.012, 7840.5, 9730, 0
121, 85, 206, At, -12439.388, 13.529, 7808.8, 9040, 0
120, 86, 206, Rn, -9132.918, 8.591, 7789.0, 4170, 0
119, 87, 206, Fr, -1246.859, 27.811, 7746.9, 6210, 0
118, 88, 206, Ra, 3565.613, 18.008, 7719.8, 0280, 0
117, 89, 206, Ac, 13484.754, 65.088, 7667.8, 5380, 0
129, 78, 207, Pt, -4140, 400, 7797, 2, 0
128, 79, 207, Au, -10640, 300, 7824, 1, 0
127, 80, 207, Hg, -16487.446, 29.808, 7848.6, 1120, 0
126, 81, 207, Tl, -21034.436, 5.439, 7866.7, 9790, 0
125, 82, 207, Pb, -22451.968, 1.147, 7869.8, 6640, 0
124, 83, 207, Bi, -20054.554, 2.397, 7854.5, 0530, 0
123, 84, 207, Po, -17145.700, 6.659, 7836.6, 7340, 0
122, 85, 207, At, -13227.482, 12.406, 7813.9, 6530, 0
121, 86, 207, Rn, -8634.742, 4.742, 7787.9, 9870, 0
120, 87, 207, Fr, -2849.021, 17.557, 7756.2, 6890, 0
119, 88, 207, Ra, 3513.988, 58.286, 7721.7, 5030, 0
118, 89, 207, Ac, 11146.228, 56.248, 7681.1, 0010, 0
130, 78, 208, Pt, -500, 400, 7780, 2, 0
129, 79, 208, Au, -5910, 300, 7803, 1, 0
128, 80, 208, Hg, -13265.408, 30.739, 7834.1, 9140, 0
127, 81, 208, Tl, -16750.121, 1.854, 7847.1, 8350, 0
126, 82, 208, Pb, -21748.519, 1.148, 7867.4, 5300, 0
125, 83, 208, Bi, -18870.151, 2.305, 7849.8, 5340, 0
124, 84, 208, Po, -17469.207, 1.672, 7839.3, 5680, 0
123, 85, 208, At, -12469.901, 8.921, 7811.5, 6040, 0
122, 86, 208, Rn, -9655.389, 10.163, 7794.2, 6780, 0
121, 87, 208, Fr, -2664.928, 11.657, 7756.8, 9850, 0
120, 88, 208, Ra, 1727.934, 9.023, 7732.0, 1770, 0
119, 89, 208, Ac, 10760.854, 64.483, 7684.8, 2890, 0
118, 90, 208, Th, 16688.041, 31.865, 7652.5, 7160, 0
130, 79, 209, Au, -2230, 400, 7786, 2, 0
129, 80, 209, Hg, -8610, 150, 7813, 1, 0
128, 81, 209, Tl, -13644.793, 6.110, 7833.3, 9790, 0
127, 82, 209, Pb, -17614.574, 1.747, 7848.6, 4880, 0
126, 83, 209, Bi, -18258.589, 1.365, 7847.9, 8690, 0
125, 84, 209, Po, -16366.015, 1.778, 7835.1, 8820, 0
124, 85, 209, At, -12883.773, 4.745, 7814.7, 8350, 0
123, 86, 209, Rn, -8941.049, 9.960, 7792.1, 7550, 0
122, 87, 209, Fr, -3782.144, 11.503, 7763.7, 4850, 0
121, 88, 209, Ra, 1858.240, 5.747, 7733.0, 1770, 0
120, 89, 209, Ac, 8844.887, 55.846, 7695.8, 4550, 0
119, 90, 209, Th, 16395, 103, 7656, 0, 0
131, 79, 210, Au, 2680, 400, 7764, 2, 0
130, 80, 210, Hg, -5300, 200, 7799, 1, 0
129, 81, 210, Tl, -9246.996, 11.603, 7813.5, 8900, 0
128, 82, 210, Pb, -14728.429, 1.448, 7835.9, 6560, 0
127, 83, 210, Bi, -14791.905, 1.364, 7832.5, 4240, 0
126, 84, 210, Po, -15953.060, 1.146, 7834.3, 4620, 0
125, 85, 210, At, -11972.099, 7.695, 7811.6, 6380, 0
124, 86, 210, Rn, -9604.764, 4.557, 7796.6, 6530, 0
123, 87, 210, Fr, -3343.508, 13.420, 7763.1, 2430, 0
122, 88, 210, Ra, 442.839, 9.193, 7741.3, 6870, 0
121, 89, 210, Ac, 8764.079, 62.208, 7698.0, 1820, 0
120, 90, 210, Th, 14059.521, 18.909, 7669.0, 7640, 0
131, 80, 211, Hg, -390, 200, 7777, 1, 0
130, 81, 211, Tl, -6077.999, 41.917, 7799.7, 9150, 0
129, 82, 211, Pb, -10493.012, 2.260, 7817.0, 0790, 0
128, 83, 211, Bi, -11859.116, 5.442, 7819.7, 7450, 0
127, 84, 211, Po, -12432.492, 1.255, 7818.7, 8420, 0
126, 85, 211, At, -11647.191, 2.729, 7811.3, 5450, 0
125, 86, 211, Rn, -8755.330, 6.813, 7793.9, 4120, 0
124, 87, 211, Fr, -4140.314, 11.991, 7768.3, 6130, 0
123, 88, 211, Ra, 831.870, 4.966, 7741.0, 8870, 0
122, 89, 211, Ac, 7143.485, 53.753, 7707.4, 6800, 0
121, 90, 211, Th, 13876.396, 86.070, 7671.8, 5060, 0
120, 91, 211, Pa, 22052.226, 69.472, 7629.3, 9480, 0
132, 80, 212, Hg, 3020, 300, 7762, 1, 0
131, 81, 212, Tl, -1551, 200, 7780, 1, 0
130, 82, 212, Pb, -7548.929, 1.840, 7804.3, 2030, 0
129, 83, 212, Bi, -8117.943, 1.853, 7803.3, 1400, 0
128, 84, 212, Po, -10369.408, 1.153, 7810.2, 4380, 0
127, 85, 212, At, -8628.149, 2.385, 7798.3, 4000, 0
126, 86, 212, Rn, -8659.219, 3.110, 7794.7, 9630, 0
125, 87, 212, Fr, -3515.998, 8.775, 7766.8, 4550, 0
124, 88, 212, Ra, -198.763, 10.254, 7747.5, 0780, 0
123, 89, 212, Ac, 7299.600, 21.883, 7708.4, 4790, 0
122, 90, 212, Th, 12110.886, 10.109, 7682.0, 6280, 0
121, 91, 212, Pa, 21596.523, 87.604, 7633.6, 2890, 0
133, 80, 213, Hg, 8200, 300, 7739, 1, 0
132, 81, 213, Tl, 1783.811, 27.013, 7765.4, 3110, 0
131, 82, 213, Pb, -3203.598, 6.954, 7785.1, 7320, 0
130, 83, 213, Bi, -5231.671, 5.082, 7791.0, 2170, 0
129, 84, 213, Po, -6653.519, 3.053, 7794.0, 2400, 0
128, 85, 213, At, -6579.522, 4.898, 7790.0, 0360, 0
127, 86, 213, Rn, -5695.949, 3.370, 7782.1, 8240, 0
126, 87, 213, Fr, -3554.199, 4.707, 7768.4, 5430, 0
125, 88, 213, Ra, 345.557, 9.818, 7746.4, 7260, 0
124, 89, 213, Ac, 6141.029, 11.665, 7715.5, 9080, 0
123, 90, 213, Th, 12120.108, 9.217, 7683.8, 4700, 0
122, 91, 213, Pa, 19654.194, 57.170, 7644.8, 0270, 0
134, 80, 214, Hg, 11770, 400, 7724, 2, 0
133, 81, 214, Tl, 6465, 196, 7745, 1, 0
132, 82, 214, Pb, -183.019, 1.969, 7772.3, 9550, 0
131, 83, 214, Bi, -1200.780, 11.209, 7773.4, 9550, 0
130, 84, 214, Po, -4469.972, 1.449, 7785.1, 1630, 0
129, 85, 214, At, -3379.151, 3.982, 7776.3, 6320, 0
128, 86, 214, Rn, -4319.664, 9.187, 7777.1, 0230, 0
127, 87, 214, Fr, -958.327, 8.519, 7757.7, 3930, 0
126, 88, 214, Ra, 92.740, 5.250, 7749.1, 7190, 0
125, 89, 214, Ac, 6433.272, 13.551, 7715.8, 8740, 0
124, 90, 214, Th, 10694.932, 10.661, 7692.3, 1730, 0
123, 91, 214, Pa, 19459.895, 81.208, 7647.7, 0370, 0
135, 80, 215, Hg, 17110, 400, 7701, 2, 0
134, 81, 215, Tl, 10030, 300, 7730, 1, 0
133, 82, 215, Pb, 4342.245, 52.685, 7752.7, 3810, 0
132, 83, 215, Bi, 1629.272, 5.624, 7761.7, 1770, 0
131, 84, 215, Po, -541.771, 2.120, 7768.1, 7680, 0
130, 85, 215, At, -1256.583, 6.629, 7767.8, 6270, 0
129, 86, 215, Rn, -1168.990, 6.090, 7763.8, 1640, 0
128, 87, 215, Fr, 318.137, 7.066, 7753.2, 6070, 0
127, 88, 215, Ra, 2531.995, 7.201, 7739.3, 2490, 0
126, 89, 215, Ac, 6030.550, 12.406, 7719.4, 1370, 0
125, 90, 215, Th, 10921.434, 6.335, 7693.0, 2660, 0
124, 91, 215, Pa, 17804.537, 82.450, 7657.3, 7330, 0
123, 92, 215, U, 24889.312, 104.136, 7620.7, 8210, 0
136, 80, 216, Hg, 20920, 400, 7685, 2, 0
135, 81, 216, Tl, 14870, 300, 7709, 1, 0
134, 82, 216, Pb, 7510, 200, 7740, 1, 0
133, 83, 216, Bi, 5873.988, 11.178, 7743.4, 9960, 0
132, 84, 216, Po, 1782.336, 1.815, 7758.8, 2050, 0
131, 85, 216, At, 2256.678, 3.575, 7753.0, 0240, 0
130, 86, 216, Rn, 253.312, 5.768, 7758.6, 5530, 0
129, 87, 216, Fr, 2971.022, 4.174, 7742.4, 5130, 0
128, 88, 216, Ra, 3291.466, 8.004, 7737.3, 4580, 0
127, 89, 216, Ac, 8149.736, 9.230, 7711.2, 3190, 0
126, 90, 216, Th, 10298.537, 11.104, 7697.6, 6170, 0
125, 91, 216, Pa, 17823.799, 24.647, 7659.2, 0060, 0
124, 92, 216, U, 23066.429, 28.093, 7631.3, 0720, 0
136, 81, 217, Tl, 18660, 400, 7693, 2, 0
135, 82, 217, Pb, 12260, 300, 7719, 1, 0
134, 83, 217, Bi, 8729.963, 17.698, 7731.8, 4910, 0
133, 84, 217, Po, 5883.452, 6.544, 7741.3, 6140, 0
132, 85, 217, At, 4394.598, 5.001, 7744.6, 1720, 0
131, 86, 217, Rn, 3658.566, 4.198, 7744.4, 0370, 0
130, 87, 217, Fr, 4314.663, 6.531, 7737.7, 7500, 0
129, 88, 217, Ra, 5889.536, 7.047, 7726.9, 1220, 0
128, 89, 217, Ac, 8702.321, 11.223, 7710.3, 4480, 0
127, 90, 217, Th, 12205.780, 10.614, 7690.5, 9450, 0
126, 91, 217, Pa, 17054.748, 12.498, 7664.6, 4380, 0
125, 92, 217, U, 22971, 81, 7634, 0, 0
137, 81, 218, Tl, 23710, 400, 7672, 2, 0
136, 82, 218, Pb, 15630, 300, 7705, 1, 0
135, 83, 218, Bi, 13216.038, 27.013, 7712.8, 2800, 0
134, 84, 218, Po, 8356.652, 1.967, 7731.5, 3000, 0
133, 85, 218, At, 8100.218, 11.503, 7729.1, 1750, 0
132, 86, 218, Rn, 5217.413, 2.316, 7738.7, 5270, 0
131, 87, 218, Fr, 7059.440, 4.235, 7726.7, 1430, 0
130, 88, 218, Ra, 6645.556, 9.807, 7725.0, 2410, 0
129, 89, 218, Ac, 10850.845, 57.616, 7702.1, 4500, 0
128, 90, 218, Th, 12366.747, 10.516, 7691.6, 0260, 0
127, 91, 218, Pa, 18649.568, 17.846, 7659.1, 9350, 0
126, 92, 218, U, 21894.655, 13.714, 7640.7, 1910, 0
137, 82, 219, Pb, 20620, 400, 7684, 2, 0
136, 83, 219, Bi, 16320, 200, 7700, 1, 0
135, 84, 219, Po, 12681.361, 15.835, 7713.3, 3400, 0
134, 85, 219, At, 10396.021, 3.237, 7720.1, 9700, 0
133, 86, 219, Rn, 8829.337, 2.100, 7723.7, 7840, 0
132, 87, 219, Fr, 8616.939, 6.874, 7721.1, 7590, 0
131, 88, 219, Ra, 9393.853, 6.814, 7714.0, 5600, 0
130, 89, 219, Ac, 11569.553, 51.477, 7700.5, 4890, 0
129, 90, 219, Th, 14462.780, 56.460, 7683.7, 6550, 0
128, 91, 219, Pa, 18583.223, 69.705, 7661.3, 7830, 0
127, 92, 219, U, 23295.953, 13.338, 7636.2, 8670, 0
126, 93, 219, Np, 29436.951, 91.969, 7604.6, 7320, 0
138, 82, 220, Pb, 24130, 400, 7670, 2, 0
137, 83, 220, Bi, 20960, 300, 7681, 1, 0
136, 84, 220, Po, 15263.462, 17.698, 7703.2, 2440, 0
135, 85, 220, At, 14375.748, 13.972, 7703.7, 0330, 0
134, 86, 220, Rn, 10611.994, 1.814, 7717.2, 5520, 0
133, 87, 220, Fr, 11482.332, 4.028, 7709.7, 4300, 0
132, 88, 220, Ra, 10272.091, 7.595, 7711.6, 8790, 0
131, 89, 220, Ac, 13743.755, 6.129, 7692.3, 5150, 0
130, 90, 220, Th, 14689.538, 13.687, 7684.4, 9640, 0
129, 91, 220, Pa, 20278.397, 14.655, 7655.5, 3640, 0
128, 92, 220, U, 23013, 101, 7640, 0, 0
127, 93, 220, Np, 30475.022, 30.718, 7602.0, 7580, 0
138, 83, 221, Bi, 24200, 300, 7668, 1, 0
137, 84, 221, Po, 19773.757, 19.561, 7684.4, 8140, 0
136, 85, 221, At, 16782.729, 13.972, 7694.4, 7540, 0
135, 86, 221, Rn, 14471.354, 5.714, 7701.3, 9410, 0
134, 87, 221, Fr, 13277.251, 4.886, 7703.2, 5720, 0
133, 88, 221, Ra, 12963.877, 4.630, 7701.1, 3520, 0
132, 89, 221, Ac, 14531.048, 56.901, 7690.5, 0390, 0
131, 90, 221, Th, 16939.926, 7.994, 7676.0, 6400, 0
130, 91, 221, Pa, 20374.937, 59.380, 7656.9, 8090, 0
129, 92, 221, U, 24519.996, 72.135, 7634.6, 8490, 0
128, 93, 221, Np, 29910, 200, 7607, 1, 0
127, 94, 221, Pu, 35930, 300, 7576, 1, 0
139, 83, 222, Bi, 28950, 300, 7648, 1, 0
138, 84, 222, Po, 22486.268, 40.054, 7674.0, 0540, 0
137, 85, 222, At, 20953.028, 15.835, 7677.3, 8780, 0
136, 86, 222, Rn, 16371.957, 1.944, 7694.4, 9910, 0
135, 87, 222, Fr, 16378.103, 7.452, 7690.9, 4740, 0
134, 88, 222, Ra, 14320.205, 4.454, 7696.6, 9310, 0
133, 89, 222, Ac, 16621.797, 4.699, 7682.8, 0150, 0
132, 90, 222, Th, 17203.039, 10.216, 7676.6, 5920, 0
131, 91, 222, Pa, 22064.361, 86.606, 7651.2, 3730, 0
130, 92, 222, U, 24272.834, 51.994, 7637.7, 6510, 0
129, 93, 222, Np, 31274.641, 38.051, 7602.7, 0130, 0
128, 94, 222, Pu, 35060, 300, 7582, 1, 0
140, 83, 223, Bi, 32240, 400, 7636, 2, 0
139, 84, 223, Po, 27079, 196, 7655, 1, 0
138, 85, 223, At, 23428.008, 13.972, 7668.0, 5570, 0
137, 86, 223, Rn, 20389.738, 7.822, 7678.1, 7200, 0
136, 87, 223, Fr, 18382.329, 1.931, 7683.6, 6550, 0
135, 88, 223, Ra, 17233.245, 2.090, 7685.3, 1010, 0
134, 89, 223, Ac, 17825.055, 6.947, 7679.1, 4790, 0
133, 90, 223, Th, 19385.402, 7.943, 7668.6, 4260, 0
132, 91, 223, Pa, 22337.614, 75.632, 7651.8, 9570, 0
131, 92, 223, U, 26045.278, 59.054, 7631.7, 6110, 0
130, 93, 223, Np, 30658.583, 82.863, 7607.5, 6540, 0
129, 94, 223, Pu, 36121, 300, 7580, 1, 0
128, 95, 223, Am, 42700, 300, 7547, 1, 0
141, 83, 224, Bi, 37070, 400, 7616, 2, 0
140, 84, 224, Po, 29910, 196, 7644, 1, 0
139, 85, 224, At, 27711.018, 22.356, 7650.7, 3540, 0
138, 86, 224, Rn, 22445.098, 9.814, 7670.7, 5140, 0
137, 87, 224, Fr, 21748.614, 11.178, 7670.3, 6800, 0
136, 88, 224, Ra, 18825.832, 1.811, 7679.9, 2360, 0
135, 89, 224, Ac, 20234.148, 4.089, 7670.1, 4380, 0
134, 90, 224, Th, 19995.581, 9.604, 7667.7, 1620, 0
133, 91, 224, Pa, 23862.351, 7.587, 7646.9, 6120, 0
132, 92, 224, U, 25742.690, 15.261, 7635.0, 7420, 0
131, 93, 224, Np, 32032.248, 28.925, 7603.5, 0320, 0
130, 94, 224, Pu, 35280, 300, 7586, 1, 0
129, 95, 224, Am, 43260, 400, 7546, 2, 0
141, 84, 225, Po, 34580, 300, 7626, 1, 0
140, 85, 225, At, 30300, 300, 7641, 1, 0
139, 86, 225, Rn, 26534.143, 11.140, 7654.3, 5810, 0
138, 87, 225, Fr, 23820.602, 11.967, 7662.9, 4120, 0
137, 88, 225, Ra, 21993.044, 2.596, 7667.5, 8660, 0
136, 89, 225, Ac, 21637.305, 4.758, 7665.6, 9060, 0
135, 90, 225, Th, 22310.193, 5.093, 7659.2, 2290, 0
134, 91, 225, Pa, 24356.640, 81.867, 7646.6, 5040, 0
133, 92, 225, U, 27372.001, 9.934, 7629.7, 7170, 0
132, 93, 225, Np, 31618.098, 91.618, 7607.4, 2310, 0
131, 94, 225, Pu, 36300, 300, 7583, 1, 0
130, 95, 225, Am, 42390, 400, 7553, 2, 0
142, 84, 226, Po, 37549, 401, 7614, 2, 0
141, 85, 226, At, 34660, 300, 7624, 1, 0
140, 86, 226, Rn, 28747.194, 10.477, 7646.4, 1080, 0
139, 87, 226, Fr, 27520.539, 6.230, 7648.3, 7680, 0
138, 88, 226, Ra, 23667.576, 1.927, 7661.9, 6360, 0
137, 89, 226, Ac, 24309.201, 3.100, 7655.6, 6280, 0
136, 90, 226, Th, 23197.649, 4.481, 7657.1, 1950, 0
135, 91, 226, Pa, 26033.600, 11.213, 7641.1, 0930, 0
134, 92, 226, U, 27328.797, 11.071, 7631.9, 1660, 0
133, 93, 226, Np, 32816.877, 102.063, 7604.1, 7140, 0
132, 94, 226, Pu, 35630, 200, 7588, 1, 0
131, 95, 226, Am, 42970, 300, 7552, 1, 0
143, 84, 227, Po, 42281, 401, 7596, 2, 0
142, 85, 227, At, 37430, 300, 7613, 1, 0
141, 86, 227, Rn, 32885.835, 14.091, 7630.0, 5080, 0
140, 87, 227, Fr, 29682.445, 5.898, 7640.7, 1620, 0
139, 88, 227, Ra, 27177.464, 1.946, 7648.3, 0480, 0
138, 89, 227, Ac, 25849.515, 1.926, 7650.7, 0840, 0
137, 90, 227, Th, 25804.759, 2.088, 7647.4, 5910, 0
136, 91, 227, Pa, 26830.371, 7.263, 7639.4, 9450, 0
135, 92, 227, U, 29045.034, 8.510, 7626.2, 9180, 0
134, 93, 227, Np, 32579.018, 76.989, 7607.2, 7710, 0
133, 94, 227, Pu, 36770, 100, 7585, 0, 0
132, 95, 227, Am, 42180, 200, 7558, 1, 0
143, 85, 228, At, 41880, 400, 7596, 2, 0
142, 86, 228, Rn, 35243.466, 17.677, 7621.6, 4570, 0
141, 87, 228, Fr, 33384.221, 6.732, 7626.3, 6890, 0
140, 88, 228, Ra, 28940.194, 1.995, 7642.4, 2890, 0
139, 89, 228, Ac, 28894.654, 2.093, 7639.1, 9730, 0
138, 90, 228, Th, 26770.899, 1.806, 7645.0, 8070, 0
137, 91, 228, Pa, 28923.599, 4.340, 7632.2, 0760, 0
136, 92, 228, U, 29220.001, 13.474, 7627.4, 7630, 0
135, 93, 228, Np, 33825, 100, 7604, 0, 0
134, 94, 228, Pu, 36107.809, 23.352, 7590.4, 0390, 0
133, 95, 228, Am, 42850, 200, 7557, 1, 0
144, 85, 229, At, 44890, 400, 7585, 2, 0
143, 86, 229, Rn, 39362.400, 13.041, 7605.6, 2270, 0
142, 87, 229, Fr, 35668.253, 5.001, 7618.3, 3800, 0
141, 88, 229, Ra, 32561.963, 15.441, 7628.4, 8620, 0
140, 89, 229, Ac, 30689.936, 12.109, 7633.2, 4460, 0
139, 90, 229, Th, 29585.517, 2.404, 7634.6, 5100, 0
138, 91, 229, Pa, 29896.848, 3.280, 7629.8, 7520, 0
137, 92, 229, U, 31210.620, 5.938, 7620.7, 2180, 0
136, 93, 229, Np, 33801.378, 101.177, 7605.9, 9210, 0
135, 94, 229, Pu, 37394.924, 60.633, 7586.8, 8340, 0
134, 95, 229, Am, 42180.414, 106.348, 7562.5, 6970, 0
144, 86, 230, Rn, 42170, 200, 7595, 1, 0
143, 87, 230, Fr, 39486.769, 6.541, 7603.7, 0520, 0
142, 88, 230, Ra, 34516.306, 10.296, 7621.9, 1440, 0
141, 89, 230, Ac, 33838.386, 15.835, 7621.4, 6040, 0
140, 90, 230, Th, 30862.512, 1.209, 7630.9, 9740, 0
139, 91, 230, Pa, 32173.543, 3.038, 7621.8, 9580, 0
138, 92, 230, U, 31615.017, 4.509, 7620.9, 2270, 0
137, 93, 230, Np, 35236.615, 55.007, 7601.7, 7510, 0
136, 94, 230, Pu, 36932.170, 14.451, 7591.0, 0160, 0
135, 95, 230, Am, 42872, 143, 7562, 1, 0
145, 86, 231, Rn, 46550, 300, 7579, 1, 0
144, 87, 231, Fr, 42080.575, 7.731, 7594.5, 0090, 0
143, 88, 231, Ra, 38216.488, 11.370, 7607.8, 4180, 0
142, 89, 231, Ac, 35762.853, 13.041, 7615.0, 7680, 0
141, 90, 231, Th, 33815.811, 1.217, 7620.1, 1880, 0
140, 91, 231, Pa, 33424.338, 1.771, 7618.4, 2670, 0
139, 92, 231, U, 33805.952, 2.670, 7613.3, 8790, 0
138, 93, 231, Np, 35623.686, 51.154, 7602.1, 3210, 0
137, 94, 231, Pu, 38308.577, 22.061, 7587.1, 2240, 0
136, 95, 231, Am, 42410, 300, 7566, 1, 0
135, 96, 231, Cm, 47270, 300, 7542, 1, 0
145, 87, 232, Fr, 46072.834, 13.972, 7579.3, 4810, 0
144, 88, 232, Ra, 40496.955, 9.151, 7600.0, 0990, 0
143, 89, 232, Ac, 39154.423, 13.041, 7602.4, 2450, 0
142, 90, 232, Th, 35446.710, 1.421, 7615.0, 3380, 0
141, 91, 232, Pa, 35946.549, 7.645, 7609.5, 0720, 0
140, 92, 232, U, 34609.445, 1.808, 7611.8, 9840, 0
139, 93, 232, Np, 37359, 100, 7597, 0, 0
138, 94, 232, Pu, 38360.915, 16.885, 7588.9, 8390, 0
137, 95, 232, Am, 43420, 300, 7564, 1, 0
136, 96, 232, Cm, 46333, 201, 7548, 1, 0
146, 87, 233, Fr, 48920.052, 19.561, 7569.2, 3980, 0
145, 88, 233, Ra, 44334.062, 8.603, 7585.5, 6440, 0
144, 89, 233, Ac, 41308.037, 13.041, 7595.1, 9390, 0
143, 90, 233, Th, 38731.642, 1.424, 7602.8, 9370, 0
142, 91, 233, Pa, 37489.410, 1.336, 7604.8, 6750, 0
141, 92, 233, U, 36919.111, 2.254, 7603.9, 5740, 0
140, 93, 233, Np, 37948.531, 50.981, 7596.1, 8160, 0
139, 94, 233, Pu, 40051.836, 54.178, 7583.7, 9680, 0
138, 95, 233, Am, 43285, 114, 7567, 0, 0
137, 96, 233, Cm, 47293.340, 81.095, 7546.0, 0200, 0
136, 97, 233, Bk, 52771, 233, 7519, 1, 0
146, 88, 234, Ra, 46930.629, 8.383, 7576.5, 4390, 0
145, 89, 234, Ac, 44841.195, 13.972, 7582.1, 2970, 0
144, 90, 234, Th, 40612.958, 2.589, 7596.8, 5570, 0
143, 91, 234, Pa, 40338.870, 4.094, 7594.6, 8370, 0
142, 92, 234, U, 38144.959, 1.129, 7600.7, 1600, 0
141, 93, 234, Np, 39954.806, 8.397, 7589.6, 3820, 0
140, 94, 234, Pu, 40349.986, 6.798, 7584.6, 0610, 0
139, 95, 234, Am, 44462, 160, 7564, 1, 0
138, 96, 234, Cm, 46722.411, 17.078, 7550.6, 8680, 0
137, 97, 234, Bk, 53395, 153, 7519, 1, 0
147, 88, 235, Ra, 51130, 300, 7561, 1, 0
146, 89, 235, Ac, 47357.160, 13.972, 7573.5, 0510, 0
145, 90, 235, Th, 44017.754, 13.041, 7584.3, 8620, 0
144, 91, 235, Pa, 42288.901, 13.972, 7588.4, 1390, 0
143, 92, 235, U, 40918.782, 1.116, 7590.9, 1510, 0
142, 93, 235, Np, 41043.044, 1.388, 7587.0, 5710, 0
141, 94, 235, Pu, 42182.346, 20.521, 7578.8, 7990, 0
140, 95, 235, Am, 44624.602, 52.780, 7565.1, 5820, 0
139, 96, 235, Cm, 48013, 102, 7547, 0, 0
138, 97, 235, Bk, 52770, 401, 7524, 2, 0
147, 89, 236, Ac, 51220.998, 38.191, 7559.2, 4230, 0
146, 90, 236, Th, 46255.203, 13.972, 7576.9, 6880, 0
145, 91, 236, Pa, 45333.955, 13.972, 7577.5, 5730, 0
144, 92, 236, U, 42444.582, 1.112, 7586.4, 8540, 0
143, 93, 236, Np, 43378.094, 50.421, 7579.2, 1480, 0
142, 94, 236, Pu, 42901.508, 1.810, 7577.9, 1920, 0
141, 95, 236, Am, 46041, 119, 7561, 1, 0
140, 96, 236, Cm, 47852.820, 17.635, 7550.3, 0900, 0
139, 97, 236, Bk, 53542, 361, 7523, 2, 0
148, 89, 237, Ac, 54020, 400, 7550, 2, 0
147, 90, 237, Th, 49955.097, 15.835, 7563.4, 4330, 0
146, 91, 237, Pa, 47527.624, 13.041, 7570.3, 8470, 0
145, 92, 237, U, 45390.133, 1.202, 7576.1, 0260, 0
144, 93, 237, Np, 44871.599, 1.120, 7574.9, 8950, 0
143, 94, 237, Pu, 45091.662, 1.697, 7570.7, 5990, 0
142, 95, 237, Am, 46570, 59, 7561, 0, 0
141, 96, 237, Cm, 49247.151, 74.399, 7546.6, 2410, 0
140, 97, 237, Bk, 53210, 230, 7527, 1, 0
139, 98, 237, Cf, 57938.255, 97.347, 7503.3, 5070, 0
148, 90, 238, Th, 52525, 283, 7555, 1, 0
147, 91, 238, Pa, 50894.043, 15.835, 7558.3, 4490, 0
146, 92, 238, U, 47307.732, 1.492, 7570.1, 2620, 0
145, 93, 238, Np, 47454.597, 1.137, 7566.2, 2200, 0
144, 94, 238, Pu, 46163.148, 1.138, 7568.3, 6110, 0
143, 95, 238, Am, 48421.421, 58.911, 7555.5, 8530, 0
142, 96, 238, Cm, 49445.203, 12.234, 7547.9, 9660, 0
141, 97, 238, Bk, 54216, 256, 7525, 1, 0
140, 98, 238, Cf, 57278, 298, 7509, 1, 0
149, 90, 239, Th, 56500, 400, 7540, 2, 0
148, 91, 239, Pa, 53337, 196, 7550, 1, 0
147, 92, 239, U, 50572.668, 1.502, 7558.5, 6240, 0
146, 93, 239, Np, 49311.005, 1.310, 7560.5, 6800, 0
145, 94, 239, Pu, 48588.220, 1.112, 7560.3, 1870, 0
144, 95, 239, Am, 49390.360, 1.982, 7553.6, 8910, 0
143, 96, 239, Cm, 51146.962, 150.070, 7543.0, 6590, 0
142, 97, 239, Bk, 54250, 207, 7527, 1, 0
141, 98, 239, Cf, 58202, 120, 7507, 1, 0
140, 99, 239, Es, 63630, 300, 7481, 1, 0
149, 91, 240, Pa, 57010, 200, 7537, 1, 0
148, 92, 240, U, 52715.497, 2.553, 7551.7, 7050, 0
147, 93, 240, Np, 52316.229, 17.032, 7550.1, 7430, 0
146, 94, 240, Pu, 50125.319, 1.105, 7556.0, 4330, 0
145, 95, 240, Am, 51510.110, 13.832, 7547.0, 1360, 0
144, 96, 240, Cm, 51724.222, 1.905, 7542.8, 6170, 0
143, 97, 240, Bk, 55664, 150, 7523, 1, 0
142, 98, 240, Cf, 57988.719, 18.034, 7510.2, 4000, 0
141, 99, 240, Es, 64225, 366, 7481, 2, 0
150, 91, 241, Pa, 59740, 300, 7528, 1, 0
149, 92, 241, U, 56197, 196, 7539, 1, 0
148, 93, 241, Np, 54315.115, 100.006, 7544.0, 4260, 0
147, 94, 241, Pu, 52955.115, 1.105, 7546.4, 3950, 0
146, 95, 241, Am, 52934.335, 1.113, 7543.2, 7950, 0
145, 96, 241, Cm, 53701.770, 1.607, 7536.8, 4880, 0
144, 97, 241, Bk, 55981, 165, 7524, 1, 0
143, 98, 241, Cf, 59327, 167, 7507, 1, 0
142, 99, 241, Es, 63893, 231, 7485, 1, 0
141, 100, 241, Fm, 69220, 300, 7459, 1, 0
150, 92, 242, U, 58620, 201, 7532, 1, 0
149, 93, 242, Np, 57416.876, 200.004, 7533.4, 0420, 0
148, 94, 242, Pu, 54716.876, 1.245, 7541.3, 2840, 0
147, 95, 242, Am, 55468.014, 1.118, 7534.9, 9170, 0
146, 96, 242, Cm, 54803.699, 1.141, 7534.5, 0400, 0
145, 97, 242, Bk, 57752, 135, 7519, 1, 0
144, 98, 242, Cf, 59386.982, 12.892, 7509.0, 9910, 0
143, 99, 242, Es, 64801, 257, 7483, 1, 0
142, 100, 242, Fm, 68400, 401, 7465, 2, 0
151, 92, 243, U, 62480, 300, 7518, 1, 0
150, 93, 243, Np, 59806, 32, 7526, 0, 0
149, 94, 243, Pu, 57754.561, 2.542, 7531.0, 0870, 0
148, 95, 243, Am, 57175.005, 1.388, 7530.1, 7420, 0
147, 96, 243, Cm, 57181.936, 1.496, 7526.9, 2610, 0
146, 97, 243, Bk, 58689.629, 4.524, 7517.5, 0210, 0
145, 98, 243, Cf, 60990, 181, 7505, 1, 0
144, 99, 243, Es, 64747, 207, 7486, 1, 0
143, 100, 243, Fm, 69316, 130, 7464, 1, 0
151, 93, 244, Np, 63240, 100, 7514, 0, 0
150, 94, 244, Pu, 59806.021, 2.346, 7524.8, 1540, 0
149, 95, 244, Am, 59879.135, 1.491, 7521.3, 0950, 0
148, 96, 244, Cm, 58451.835, 1.106, 7523.9, 5270, 0
147, 97, 244, Bk, 60713.825, 14.399, 7511.4, 7590, 0
146, 98, 244, Cf, 61478.096, 2.617, 7505.1, 3730, 0
145, 99, 244, Es, 66026, 181, 7483, 1, 0
144, 100, 244, Fm, 68964, 201, 7468, 1, 0
143, 101, 244, Md, 75597, 374, 7438, 2, 0
152, 93, 245, Np, 65850, 200, 7506, 1, 0
151, 94, 245, Pu, 63178.173, 13.620, 7513.2, 8220, 0
150, 95, 245, Am, 61900.417, 1.886, 7515.3, 0430, 0
149, 96, 245, Cm, 61004.524, 1.149, 7515.7, 6770, 0
148, 97, 245, Bk, 61813.776, 1.792, 7509.2, 7140, 0
147, 98, 245, Cf, 63385.151, 2.428, 7499.6, 6440, 0
146, 99, 245, Es, 66315, 165, 7485, 1, 0
145, 100, 245, Fm, 70192, 195, 7465, 1, 0
144, 101, 245, Md, 75325, 260, 7441, 1, 0
152, 94, 246, Pu, 65394.772, 14.985, 7506.5, 4010, 0
151, 95, 246, Am, 64994, 18, 7505, 0, 0
150, 96, 246, Cm, 62616.912, 1.525, 7511.4, 7160, 0
149, 97, 246, Bk, 63966.912, 60.019, 7502.8, 0350, 0
148, 98, 246, Cf, 64090.228, 1.514, 7499.1, 2200, 0
147, 99, 246, Es, 67818.802, 89.925, 7480.7, 8490, 0
146, 100, 246, Fm, 70191.187, 13.670, 7467.9, 6080, 0
145, 101, 246, Md, 76115, 260, 7441, 1, 0
153, 94, 247, Pu, 69210, 200, 7493, 1, 0
152, 95, 247, Am, 67153, 100, 7499, 0, 0
151, 96, 247, Cm, 65533.105, 3.797, 7501.9, 3180, 0
150, 97, 247, Bk, 65489.521, 5.189, 7498.9, 4080, 0
149, 98, 247, Cf, 66109.392, 14.327, 7493.2, 6380, 0
148, 99, 247, Es, 68578.393, 19.441, 7480.1, 0050, 0
147, 100, 247, Fm, 71672, 181, 7464, 1, 0
146, 101, 247, Md, 75936, 207, 7444, 1, 0
153, 95, 248, Am, 70563, 200, 7487, 1, 0
152, 96, 248, Cm, 67392.748, 2.358, 7496.7, 2910, 0
151, 97, 248, Bk, 68131.053, 50.058, 7490.5, 9750, 0
150, 98, 248, Cf, 67237.951, 5.121, 7491.0, 4400, 0
149, 99, 248, Es, 70299, 52, 7476, 0, 0
148, 100, 248, Fm, 71897.793, 8.497, 7465.9, 4510, 0
147, 101, 248, Md, 76948, 184, 7442, 1, 0
146, 102, 248, No, 80689, 224, 7424, 1, 0
154, 95, 249, Am, 73104, 298, 7479, 1, 0
153, 96, 249, Cm, 70750.696, 2.371, 7485.5, 5100, 0
152, 97, 249, Bk, 69846.333, 1.248, 7486.0, 4100, 0
151, 98, 249, Cf, 69722.733, 1.182, 7483.3, 9540, 0
150, 99, 249, Es, 71175, 30, 7474, 0, 0
149, 100, 249, Fm, 73519.143, 6.212, 7461.8, 6490, 0
148, 101, 249, Md, 77180.952, 164.425, 7444.0, 1690, 0
147, 102, 249, No, 81787, 279, 7422, 1, 0
154, 96, 250, Cm, 72989.588, 10.274, 7478.9, 3850, 0
153, 97, 250, Bk, 72952.006, 2.898, 7475.9, 5940, 0
152, 98, 250, Cf, 71170.336, 1.538, 7479.9, 5670, 0
151, 99, 250, Es, 73225, 100, 7469, 0, 0
150, 100, 250, Fm, 74072.193, 7.888, 7462.0, 9050, 0
149, 101, 250, Md, 78399.140, 90.920, 7441.6, 5330, 0
148, 102, 250, No, 81566, 200, 7426, 1, 0
155, 96, 251, Cm, 76647.981, 22.698, 7466.7, 2330, 0
154, 97, 251, Bk, 75227.981, 10.734, 7469.2, 6370, 0
153, 98, 251, Cf, 74134.981, 3.901, 7470.5, 0140, 0
152, 99, 251, Es, 74511.547, 5.288, 7465.8, 8420, 0
151, 100, 251, Fm, 75958.808, 14.292, 7457.0, 0130, 0
150, 101, 251, Md, 78966.749, 18.919, 7441.9, 0050, 0
149, 102, 251, No, 82849, 181, 7423, 1, 0
148, 103, 251, Lr, 87830, 200, 7400, 1, 0
156, 96, 252, Cm, 79056, 298, 7460, 1, 0
155, 97, 252, Bk, 78535, 200, 7459, 1, 0
154, 98, 252, Cf, 76034.610, 2.358, 7465.3, 4740, 0
153, 99, 252, Es, 77294.610, 50.056, 7457.2, 4280, 0
152, 100, 252, Fm, 76816.611, 5.221, 7456.0, 3510, 0
151, 101, 252, Md, 80467.118, 91.286, 7438.4, 4440, 0
150, 102, 252, No, 82871.370, 9.292, 7425.7, 9920, 0
149, 103, 252, Lr, 88537, 185, 7400, 1, 0
156, 97, 253, Bk, 80929, 359, 7451, 1, 0
155, 98, 253, Cf, 79301.562, 4.257, 7454.8, 2970, 0
154, 99, 253, Es, 79010.486, 1.249, 7452.8, 8790, 0
153, 100, 253, Fm, 79345.549, 1.549, 7448.4, 7120, 0
152, 101, 253, Md, 81173, 31, 7438, 0, 0
151, 102, 253, No, 84358.696, 6.912, 7422.4, 7190, 0
150, 103, 253, Lr, 88523.471, 164.534, 7402.9, 1800, 0
149, 104, 253, Rf, 93642, 410, 7380, 2, 0
157, 97, 254, Bk, 84393, 298, 7440, 1, 0
156, 98, 254, Cf, 81341.395, 11.462, 7449.2, 2590, 0
155, 99, 254, Es, 81994.151, 2.936, 7443.5, 7590, 0
154, 100, 254, Fm, 80902.521, 1.843, 7444.7, 9360, 0
153, 101, 254, Md, 83453, 100, 7432, 0, 0
152, 102, 254, No, 84723.312, 9.658, 7423.5, 9090, 0
151, 103, 254, Lr, 89645.887, 91.312, 7401.1, 3060, 0
150, 104, 254, Rf, 93201, 283, 7384, 1, 0
157, 98, 255, Cf, 84809, 200, 7438, 1, 0
156, 99, 255, Es, 84089.237, 10.817, 7437.8, 2160, 0
155, 100, 255, Fm, 83800.465, 3.934, 7435.8, 8600, 0
154, 101, 255, Md, 84842.069, 5.567, 7428.7, 3330, 0
153, 102, 255, No, 86811.934, 14.047, 7417.9, 4030, 0
152, 103, 255, Lr, 89947.305, 17.698, 7402.5, 7670, 0
151, 104, 255, Rf, 94329, 181, 7382, 1, 0
150, 105, 255, Db, 99595, 283, 7359, 1, 0
158, 98, 256, Cf, 87041, 314, 7432, 1, 0
157, 99, 256, Es, 87185, 100, 7428, 0, 0
156, 100, 256, Fm, 85484.796, 3.020, 7431.7, 8880, 0
155, 101, 256, Md, 87456, 124, 7421, 0, 0
154, 102, 256, No, 87823.046, 7.548, 7416.5, 4290, 0
153, 103, 256, Lr, 91746.603, 82.903, 7398.1, 6050, 0
152, 104, 256, Rf, 94221.992, 17.848, 7385.4, 3490, 0
151, 105, 256, Db, 100298, 187, 7359, 1, 0
158, 99, 257, Es, 89403, 411, 7422, 2, 0
157, 100, 257, Fm, 88590.137, 4.350, 7422.1, 9420, 0
156, 101, 257, Md, 88992.472, 1.569, 7417.5, 8450, 0
155, 102, 257, No, 90247.064, 6.197, 7409.6, 5870, 0
154, 103, 257, Lr, 92665, 44, 7397, 0, 0
153, 104, 257, Rf, 95866.389, 10.817, 7381.7, 0530, 0
152, 105, 257, Db, 100154.285, 164.634, 7361.9, 7670, 0
159, 99, 258, Es, 92702, 401, 7412, 2, 0
158, 100, 258, Fm, 90426, 200, 7418, 1, 0
157, 101, 258, Md, 91690.350, 3.474, 7409.6, 6150, 0
156, 102, 258, No, 91477, 100, 7407, 0, 0
155, 103, 258, Lr, 94782, 102, 7392, 0, 0
154, 104, 258, Rf, 96344.338, 16.104, 7382.5, 2570, 0
153, 105, 258, Db, 101507.703, 91.857, 7359.4, 8030, 0
152, 106, 258, Sg, 105296, 413, 7342, 2, 0
159, 100, 259, Fm, 93704, 283, 7407, 1, 0
158, 101, 259, Md, 93564, 101, 7405, 0, 0
157, 102, 259, No, 94079.381, 6.362, 7399.9, 7140, 0
156, 103, 259, Lr, 95851, 71, 7390, 0, 0
155, 104, 259, Rf, 98367, 72, 7377, 0, 0
154, 105, 259, Db, 101991.021, 56.685, 7360.3, 6260, 0
153, 106, 259, Sg, 106519, 181, 7340, 1, 0
160, 100, 260, Fm, 95766, 435, 7402, 2, 0
159, 101, 260, Md, 96550, 316, 7396, 1, 0
158, 102, 260, No, 95610, 200, 7397, 1, 0
157, 103, 260, Lr, 98277, 125, 7383, 0, 0
156, 104, 260, Rf, 99148, 200, 7377, 1, 0
155, 105, 260, Db, 103673, 93, 7357, 0, 0
154, 106, 260, Sg, 106547.495, 20.536, 7342.5, 6320, 0
153, 107, 260, Bh, 113123, 196, 7314, 1, 0
160, 101, 261, Md, 98578, 509, 7391, 2, 0
159, 102, 261, No, 98455, 200, 7388, 1, 0
158, 103, 261, Lr, 99557, 200, 7381, 1, 0
157, 104, 261, Rf, 101318.233, 65.663, 7371.3, 8580, 0
156, 105, 261, Db, 104308, 110, 7357, 0, 0
155, 106, 261, Sg, 108005.004, 18.494, 7339.7, 7100, 0
154, 107, 261, Bh, 113079.410, 179.803, 7317.3, 3130, 0
161, 101, 262, Md, 101667, 448, 7382, 2, 0
160, 102, 262, No, 100101, 361, 7385, 1, 0
159, 103, 262, Lr, 102105, 200, 7374, 1, 0
158, 104, 262, Rf, 102392, 224, 7370, 1, 0
157, 105, 262, Db, 106253, 143, 7352, 1, 0
156, 106, 262, Sg, 108369.072, 22.167, 7341.1, 7360, 0
155, 107, 262, Bh, 114252.119, 93.074, 7315.7, 3310, 0
161, 102, 263, No, 103129, 490, 7376, 2, 0
160, 103, 263, Lr, 103669, 224, 7371, 1, 0
159, 104, 263, Rf, 104757, 153, 7364, 1, 0
158, 105, 263, Db, 107110, 168, 7352, 1, 0
157, 106, 263, Sg, 110195, 95, 7337, 0, 0
156, 107, 263, Bh, 114496, 305, 7318, 1, 0
155, 108, 263, Hs, 119678, 197, 7295, 1, 0
162, 102, 264, No, 105011, 591, 7371, 2, 0
161, 103, 264, Lr, 106375, 436, 7363, 2, 0
160, 104, 264, Rf, 106075, 361, 7361, 1, 0
159, 105, 264, Db, 109262, 236, 7346, 1, 0
158, 106, 264, Sg, 110783, 283, 7338, 1, 0
157, 107, 264, Bh, 115958, 177, 7315, 1, 0
156, 108, 264, Hs, 119563.165, 28.881, 7298.3, 7620, 0
162, 103, 265, Lr, 108233, 547, 7359, 2, 0
161, 104, 265, Rf, 108690, 361, 7354, 1, 0
160, 105, 265, Db, 110382, 224, 7345, 1, 0
159, 106, 265, Sg, 112794, 139, 7333, 1, 0
158, 107, 265, Bh, 116395, 239, 7316, 1, 0
157, 108, 265, Hs, 120900.245, 23.958, 7296.2, 4740, 0
156, 109, 265, Mt, 126624, 439, 7272, 2, 0
163, 103, 266, Lr, 111662, 539, 7349, 2, 0
162, 104, 266, Rf, 110136, 412, 7351, 2, 0
161, 105, 266, Db, 112740, 283, 7339, 1, 0
160, 106, 266, Sg, 113617, 245, 7332, 1, 0
159, 107, 266, Bh, 118104, 163, 7313, 1, 0
158, 108, 266, Hs, 121139.675, 27.106, 7298.2, 6110, 0
157, 109, 266, Mt, 127672.681, 96.473, 7270.7, 5980, 0
163, 104, 267, Rf, 113444, 575, 7342, 2, 0
162, 105, 267, Db, 114014, 374, 7337, 1, 0
161, 106, 267, Sg, 115806, 261, 7327, 1, 0
160, 107, 267, Bh, 118765, 263, 7313, 1, 0
159, 108, 267, Hs, 122658, 95, 7295, 0, 0
158, 109, 267, Mt, 127791, 503, 7273, 2, 0
157, 110, 267, Ds, 133880, 204, 7248, 1, 0
164, 104, 268, Rf, 115476, 662, 7337, 2, 0
163, 105, 268, Db, 117060, 529, 7328, 2, 0
162, 106, 268, Sg, 116800, 469, 7326, 2, 0
161, 107, 268, Bh, 120707, 382, 7309, 1, 0
160, 108, 268, Hs, 122968, 300, 7297, 1, 0
159, 109, 268, Mt, 129151, 233, 7271, 1, 0
158, 110, 268, Ds, 133648, 301, 7252, 1, 0
164, 105, 269, Db, 119148, 624, 7323, 2, 0
163, 106, 269, Sg, 119692, 368, 7318, 1, 0
162, 107, 269, Bh, 121477, 374, 7309, 1, 0
161, 108, 269, Hs, 124493, 131, 7294, 0, 0
160, 109, 269, Mt, 129300, 312, 7274, 1, 0
159, 110, 269, Ds, 134834.671, 31.403, 7250.1, 5510, 0
165, 105, 270, Db, 122397, 575, 7314, 2, 0
164, 106, 270, Sg, 121431, 458, 7314, 2, 0
163, 107, 270, Bh, 124230, 299, 7301, 1, 0
162, 108, 270, Hs, 125112, 248, 7295, 1, 0
161, 109, 270, Mt, 130709, 191, 7271, 1, 0
160, 110, 270, Ds, 134681.584, 39.275, 7253.7, 6340, 0
165, 106, 271, Sg, 124617, 591, 7305, 2, 0
164, 107, 271, Bh, 125859, 384, 7298, 1, 0
163, 108, 271, Hs, 127691, 276, 7288, 1, 0
162, 109, 271, Mt, 131100, 330, 7273, 1, 0
161, 110, 271, Ds, 135952, 97, 7252, 0, 0
166, 106, 272, Sg, 126520, 692, 7301, 3, 0
165, 107, 272, Bh, 128787, 532, 7290, 2, 0
164, 108, 272, Hs, 129004, 510, 7286, 2, 0
163, 109, 272, Mt, 133481, 485, 7267, 2, 0
162, 110, 272, Ds, 136083, 424, 7255, 2, 0
161, 111, 272, Rg, 142773, 233, 7227, 1, 0
167, 106, 273, Sg, 129920, 400, 7292, 1, 0
166, 107, 273, Bh, 130683, 655, 7286, 2, 0
165, 108, 273, Hs, 131767, 374, 7279, 1, 0
164, 109, 273, Mt, 134782, 424, 7265, 2, 0
163, 110, 273, Ds, 138285, 142, 7250, 1, 0
162, 111, 273, Rg, 142885, 400, 7230, 1, 0
167, 107, 274, Bh, 133762, 578, 7278, 2, 0
166, 108, 274, Hs, 133406, 469, 7276, 2, 0
165, 109, 274, Mt, 137249, 377, 7259, 1, 0
164, 110, 274, Ds, 139197, 389, 7249, 1, 0
163, 111, 274, Rg, 144612, 209, 7227, 1, 0
168, 107, 275, Bh, 135780, 600, 7273, 2, 0
167, 108, 275, Hs, 136492, 593, 7268, 2, 0
166, 109, 275, Mt, 138767, 387, 7257, 1, 0
165, 110, 275, Ds, 141666, 340, 7243, 1, 0
164, 111, 275, Rg, 145395, 446, 7227, 2, 0
169, 107, 276, Bh, 138950, 600, 7265, 2, 0
168, 108, 276, Hs, 138185, 720, 7265, 3, 0
167, 109, 276, Mt, 141312, 532, 7250, 2, 0
166, 110, 276, Ds, 142539, 548, 7243, 2, 0
165, 111, 276, Rg, 147386, 629, 7223, 2, 0
164, 112, 276, Cn, 150360, 500, 7209, 2, 0
170, 107, 277, Bh, 141100, 600, 7260, 2, 0
169, 108, 277, Hs, 141375, 447, 7256, 2, 0
168, 109, 277, Mt, 143008, 662, 7247, 2, 0
167, 110, 277, Ds, 145092, 392, 7237, 1, 0
166, 111, 277, Rg, 148407, 469, 7222, 2, 0
165, 112, 277, Cn, 152332, 153, 7205, 1, 0
171, 107, 278, Bh, 144370, 400, 7251, 1, 0
170, 108, 278, Hs, 143220, 300, 7252, 1, 0
169, 109, 278, Mt, 145767, 579, 7240, 2, 0
168, 110, 278, Ds, 146251, 510, 7236, 2, 0
167, 111, 278, Rg, 150521, 389, 7218, 1, 0
166, 112, 278, Cn, 152842, 438, 7206, 2, 0
165, 113, 278, Nh, 159030, 224, 7181, 1, 0
171, 108, 279, Hs, 146500, 600, 7243, 2, 0
170, 109, 279, Mt, 147585, 671, 7237, 2, 0
169, 110, 279, Ds, 149024, 605, 7229, 2, 0
168, 111, 279, Rg, 151721, 422, 7216, 2, 0
167, 112, 279, Cn, 155021, 395, 7202, 1, 0
166, 113, 279, Nh, 159460, 600, 7183, 2, 0
172, 108, 280, Hs, 148420, 600, 7239, 2, 0
171, 109, 280, Mt, 150510, 600, 7229, 2, 0
170, 110, 280, Ds, 150320, 748, 7227, 3, 0
169, 111, 280, Rg, 153886, 532, 7212, 2, 0
168, 112, 280, Cn, 155654, 583, 7202, 2, 0
167, 113, 280, Nh, 161240, 400, 7180, 1, 0
172, 109, 281, Mt, 152400, 600, 7225, 2, 0
171, 110, 281, Ds, 153273, 493, 7220, 2, 0
170, 111, 281, Rg, 155333, 774, 7209, 3, 0
169, 112, 281, Cn, 157947, 397, 7197, 1, 0
168, 113, 281, Nh, 161810, 300, 7181, 1, 0
173, 109, 282, Mt, 155455, 447, 7218, 2, 0
172, 110, 282, Ds, 154790, 300, 7217, 1, 0
171, 111, 282, Rg, 157742, 588, 7204, 2, 0
170, 112, 282, Cn, 158826, 548, 7197, 2, 0
169, 113, 282, Nh, 163729, 400, 7177, 1, 0
173, 110, 283, Ds, 157830, 500, 7210, 2, 0
172, 111, 283, Rg, 159380, 678, 7201, 2, 0
171, 112, 283, Cn, 161337, 615, 7192, 2, 0
170, 113, 283, Nh, 164563, 437, 7177, 2, 0
174, 110, 284, Ds, 159460, 500, 7207, 2, 0
173, 111, 284, Rg, 161970, 500, 7195, 2, 0
172, 112, 284, Cn, 162415, 762, 7191, 3, 0
171, 113, 284, Nh, 166591, 533, 7173, 2, 0
170, 114, 284, Fl, 168779, 656, 7163, 2, 0
174, 111, 285, Rg, 163730, 600, 7192, 2, 0
173, 112, 285, Cn, 165086, 507, 7185, 2, 0
172, 113, 285, Nh, 167768, 775, 7172, 3, 0
171, 114, 285, Fl, 170932, 404, 7159, 1, 0
175, 111, 286, Rg, 166510, 458, 7185, 2, 0
174, 112, 286, Cn, 166450, 700, 7183, 2, 0
173, 113, 286, Nh, 169957, 590, 7168, 2, 0
172, 114, 286, Fl, 171606, 549, 7159, 2, 0
175, 112, 287, Cn, 169370, 700, 7176, 2, 0
174, 113, 287, Nh, 171455, 707, 7166, 2, 0
173, 114, 287, Fl, 173929, 617, 7155, 2, 0
172, 115, 287, Mc, 177748, 443, 7139, 2, 0
176, 112, 288, Cn, 170930, 700, 7174, 2, 0
175, 113, 288, Nh, 173970, 700, 7160, 2, 0
174, 114, 288, Fl, 174917, 763, 7154, 3, 0
173, 115, 288, Mc, 179666, 536, 7135, 2, 0
176, 113, 289, Nh, 175550, 500, 7158, 2, 0
175, 114, 289, Fl, 177465, 511, 7149, 2, 0
174, 115, 289, Mc, 180683, 776, 7135, 3, 0
173, 116, 289, Lv, 184457, 503, 7119, 2, 0
177, 113, 290, Nh, 178315, 469, 7152, 2, 0
176, 114, 290, Fl, 178731, 700, 7147, 2, 0
175, 115, 290, Mc, 182792, 592, 7131, 2, 0
174, 116, 290, Lv, 185028, 552, 7120, 2, 0
177, 114, 291, Fl, 181500, 700, 7141, 2, 0
176, 115, 291, Mc, 184180, 735, 7129, 3, 0
175, 116, 291, Lv, 187244, 623, 7116, 2, 0
174, 117, 291, Ts, 191653, 597, 7098, 2, 0
177, 115, 292, Mc, 186600, 700, 7124, 2, 0
176, 116, 292, Lv, 188133, 763, 7116, 3, 0
175, 117, 292, Ts, 193621, 669, 7095, 2, 0
177, 116, 293, Lv, 190568, 515, 7111, 2, 0
176, 117, 293, Ts, 194428, 778, 7095, 3, 0
175, 118, 293, Og, 198802, 709, 7078, 2, 0
177, 117, 294, Ts, 196397, 593, 7092, 2, 0
176, 118, 294, Og, 199320, 553, 7079, 2, 0
177, 118, 295, Og, 201369, 655, 7076, 2, 0
